sinopsis	genero
convenc tres amig jug part cart harry mafios barri part sol pierd diner sin medi millon libr deb pag seman mafios pretend qued local padr cuatr amig plan form	Comedia
agent cuy llev comet asesinat call nuev york mortal jueg gat empiez cruz camin solitari hombr llam asesin personaj sol beb ocup plant medi encuentr años pued hombr asesin famili	Crimen
punt cas ven futur sufr accident qued embarg terribl enamor mar respons accident padr famili tres hij	Drama
sufr despues regres decid trabaj nocturn individu contact gent observ violenci ciud nuev york tod dia decid pas accion	Crimen
ladron poc mont acept gran golp vend diamant rob cien mil marc deb entreg trafic pierd diner berlin ultim llam novi años decid situacion once cuarent minut si minut recuper diner hombr muert desesper jov haci capital minut encontr cien mil marc reun salv hombr vid	Acción
estudi años envi años pas viaj tiemp invent gran amig excentr cientif doc brown	Aventura
com contrat rescat mision result viaj regres cuent result ser cazador alienigen qued victim	Ciencia ficción
ladron diamant entreg enorm jef camin combat realid tramp atrac enter contrat tony encontr diamant pront descubr destin captur desaparec llev mund jueg corr mezcl form perr diamant gran armas negr	Crimen
accident coch juli pierd espos hij ambos recuper juli decid nuev vid independient solitari alej disfrut proposit cruz period music intent prob juli famos mar pretend vid ayud enamor juli años atras convenc termin conciert europ ambici obra music	Drama
profund problem sufr provoc divorci seri suced vid ver oblig volv natal intent gan vid pued	Comedia
jov comienz ser conoc coch perr esper despues cur intent dueñ asi conoc hombr mayor animal descubr obsesion espi mund	Drama
fri tony lleg cub instal propon hac nombr dentr crim organiz flor junt amig inici carrer	Acción
italian une seis problem comun jov sacerdot envi pequeñ barri cur viv enfrent cos facil hotel conoc tim aprovech noch nocturn italian alli conoc ayud amig clas italian empiez produc suced	Comedia
dos monj viv baj mir viej jov ve pas vid niñ monj intent libr veran monj adolescent conoc amor monj años intent hac va monj lleg viej monj jueg niñ monj	Drama
fri hombr negoci conoc jov atract prostitut seman acompañ client ello chic ver somet cambi tras nadi podr ver vist chic call	Comedia
hombr par dia person mism nombr dos maton apartament millonari prim error visit esper viej embarg hero ven atrap herman mezcl traicion drog	Comedia
chris ambici jov profesor graci amist tom consig alta socied enamor herman tom part sal ric atract american chris pasion llev chris comet accion vid demas siempr	Drama
jov agent lleg chicag deten va ser facil puest polic conoc jimmy veteran cuerp pid ayud cruz	Crimen
charli niñ buen famili pobr gan concurs junt cuatr niñ diferent part mund disfrut visit dia gigantesc fabric dirig excentr johnny equip fabric parec mund magic llen diferent	Aventura
documental dur vid viv filmaffinity	Documental
tierr medi señor oscur sauron cre grand anill pod tres rey siet señor nuev hombr mortal secret sauron anill anill unic pod tod tierr medi ayud grup amig valient ali emprend peligr viaj mision destru anill unic señor oscur sauron cre anill envi persegu grup si sauron logr recuper anill final tierr medi	Aventura
compañ anill anill amig sam dirig haci mordor destru anill unic acab pod sauron mientr tras dur batall hombr intent rescat secuestr mordor part sauron continu plan mordor esper guerr raz libr tierr medi	Aventura
fuerz sid destru lleg moment dec destin tierr medi primer vez tiemp parec pequeñ esper señor oscur sauron centr ahor ultim hombr ocup puest rey fuerz sauron prep lanz ultim ataqu batall decid destin mientr sam continu camin haci mordor esper sauron dos pequeñ acerc cad dia final camin mont destin	Aventura
adapt anim novel centr primer mit the the primer part the tierr medi verd embarc larg peligr aventur evit anill magic pertenec ahor pod malv sauron dueñ mordor	Aventura
plen guerr fri jef part comun gobiern pais baj ley ejerc especial cre	Drama
harry regres año aun ocurr tres deb regres harry conviert centr comun magic mientr luch problem colegi inclu nuev profesor intent aprend misteri orden	Aventura
danny junt zon estadounidens amist larg años ejercit dos combat encontr valient amor vid pront llam fuerz britan combat nazis ejercit estadounidens mientr danny envi bas vez alli ambos enamor mientr combat ambos sobreviv regres complic produc mortal part ejercit japones	Acción
enfrent futur jov estudi decid estudi tren ir	Drama
tras sufr ataqu jov emprend camin busc cur mientr human acab dios convert hac posibl proteg princes guerrer deb band decid si ayud hombr intent deten her cuerp	Aventura
niñ diez años padr nuev camin famili enorm edifici cuy centr larg lad ciud fantasm restaur abandon ciud padr encuentr gran decid qued com prob transform pres huy empiez univers salv padr niñ enfrent terribl aspect	Animación
jul vincent dos asesin poc trabaj wallac vincent jul cuid muj jul peligr novi jef lleg hor trabaj ambos deb pon man obra mision recuper misteri	Suspense
tras pas unas franci agent secret jam recib llam jef realiz peligr mision relacion diamant desaparec	Aventura
detall famos gir grup rock britan the realiz unid tragic conciert celebr pues marc final gener amor convirt golp gener	Documental
bas histori real captur japones guerr mundial 1939-1945 oblig famos muert	Drama
siempr ofrec herman firm comedi gir narr histori tres tras escap carcel decid plen gan diner cancion exit destac clooney talent comedi llev mejor music band pelicul gran	Aventura
documental principal gir britan ofrec bob american nombr real cont sol años gir apen seman detall cam sig alli va hotel conciert ademas cont artist alan documental tiemp import filmaffinity	Documental
llen ser person fortun part moment bell intent hac diner logr objet plan cont complic	Drama
hombr tiemp caden television envi año inform dia viaj regres equip ven sorprend oblig regres pequeñ ciud siguient mism anterior	Romance
abandon londr llev vez instal enamor jov empiez visit noch va beb sangr convert asi espos sufr jov famili busc ayud doctor van	Terror
viv ciud brillant futur noch bod suen llam inform muert padr ve oblig situacion mund cre inclu espos ningun regres padr viv herman mayor hombr aspect solitari mental impid mism ver com va sal pas trat manten alej muj invent tras	Drama
pelicul catol dec pelicul trat dos niñ maltrat escuel catol luch enfrent tard ident haci sacerdot	Drama
chic american dot gran inteligent imagin tras escap muert casi segur comienz sufr llev nunc imagin descubr mund pues gran comet seri	Fantasía
veran dos mar jack conoc mientr hac ser contrat joe dos aspir consegu trabaj cas form famili envi cuid gan ambos surg sentimient haci relacion intim veran abandon segu camin diferent	Drama
pelicul sentimient grup joven estudi envi primer guerr mundial adapt novel escritor aleman mar provoc enfrent nazis comun	Drama
dos angel berlin ciud mur sol niñ hombr corazon testig pued cambi gran ser human decid conoc sentimient mortal enamor jov	Drama
principi años ingenu jov puebl enamor hombr trabaj pes rig comun pertenec cas tras bod vuelv trabaj cuent dias esper vuelt cre amor dia suced terribl accident primer pelicul corazon	Drama
año histori pod espad magic conoc destin verd este quier segu siend guerrer decid espad mejor amig lleg moment entreg enamor guerrer encarg llev ciud encuentr compañer embarg noch entra cas rob espad asi lanz busqued destin verd ello viej fantasm pas	Aventura
doc años antoin ve oblig sol conviv problem padr sin profesor dia cumpl decid hac amig inesper ve madr compañ hombr mied seri van anim des dej atras problem sueñ conoc mar plan escap	Drama
histori chic envi cuid hombr qued terribl accident chic habil especial hombr bord	Romance
corr año polit revolucionari cientif secret caus grup rival quier control chic extrañ poder sid manten baj años medi jov llam liber	Animación
par asesin consig huir prision dej tras horribl detectiv jack qued sac ayud encontr criminal embarg sol hor deb regres carcel	Suspense
pas padr hij gener destin tren nuev york conoc	Comedia
sigl jam kirk nav enterpris mision extrañ cuerp tierr capitan doctor ayud kirk descubr cuerp inteligent orig enterpris entonc centr oper	Ciencia ficción
bob charlott dos norteamerican encuentr bob estrell cin ven rod anunci charlott muj jov acompañ tod part mar trabaj dorm camin bob charlott cruz tard nac amist aventur junt vid nocturn compart habit ciud termin descubr nuev maner ver vid	Drama
enterpris transport grup cientif dispon pon prueb mayor experiment imagin hombr vid planet	Acción
wayn regres continu guerr crim ayud jim gordon batm propon destru crim organiz ciud gotham repent aparec nuev criminal desencaden	Drama
extrañ comedi acerc dos herman quier suicid trat evit padr dej libr conoc muj har vid mejor nuev problem	Comedia
tras planet tripul enterpris dispon cuerp compañer padr este	Ciencia ficción
dos joven dedic viv ultim dias tod norm histori narr mod comedi present situacion provoc aunqu intim protagon limit mar aleman logr pelicul gan mejor pelicul	Comedia
expuls noch apartament compart novi tras ser sorprend compañ muj atract alex qued call alli conoc walt llev fiest present propietari gran apartament import compart pues alex	Comedia
dud famos histori tren lleg pas cam mientr convirt rapid absolut llam	Documental
danny oce ladron tan sol hor despues cumpl larg conden prision plan objet realiz mayor atrac casin histori ello form equip once hombr cad mejor camp embarg surg problem inesper dueñ local sal	Suspense
vez viv dedic part vid cre criatur perfect llam mur repent dej vez unas horribl man pobr viv sol encant jov trabaj firm llev cas junt famili criatur tan especial prepar viv ciud tan extravag suburbi	Fantasía
pas tres años danny oce georg clooney equip detall expert don frank llev cab atrac histori rob despiad andy ultim cam veg despues millon consegu cad conoc miembr equip oce trat bien pas llev vid result ser juli espos danny	Suspense
bell jov alta socied baj vid escond gran comport algun man lujos joy dia mism edifici paul escritor mientr esper exit nunc lleg viv relacion muj mantien paul amist	Comedia
doc vuelv hac exit tiemp dirig cort problem famili cos sal mal graci maton ultim intent cos encuentr destin car car padr adolescent nuev	Aventura
años nuev pront hac amig dos encontr chic enamor problem padr dej ir fiest filmaffinity	Drama
siend desafi ser planet anunci part tierr rest ir situacion dej pregunt acerc propi habil realid fantas	Ciencia ficción
sigl misteri pod alienigen amenaz tierr destru intent salv human capitan kirk tripul viaj tiemp regres san francisc encontr mund cambi result tan alienigen encontr	Ciencia ficción
grup polic angel enfrent misteri asesin victim salvaj pront jef grup capitan descubr enemig alienigen lleg tierr unic proposit practic	Ciencia ficción
londr call ahor desiert tras acab mayor part poblacion lug ser terrorif tras grup animal sangr produc devast dias pais sol qued supervivient	Terror
adapt frank autor city famos batall objet conquist desencaden guerr medic dad situacion rey enfrent ejercit superior	Acción
nav enterpris dirig planet negoci liber secuestr alli descubr jef band obsesion encontr planet consider vid	Ciencia ficción
adapt novel juli deb relat hab vist monstru sur unid buqu guerr destru alter tranquil mar monstru atac evit tras buqu tripul rescat propi monstru result ser buqu capaz mar entonc	Aventura
tras años guerr dispon celebr negoci enemig kirk nav atac enterpris ambos mund prep pued ser encuentr	Ciencia ficción
jov frances talent especial ayud profesor experiment niñ viv pequeñ poblacion junt gran amig ahor perd padr trabaj pes ello mar consig vid llen baj	Aventura
hombr llam despiert dentr cam lad encuentr person gordon hombr muert man ningun dos sab alli sol dic gordon deb mat ocho hor si ambos mor junt espos hij investig asesinat llev cab detectiv llam gordon descubr siend victim conoc jigsaw sol qued unas hor complic asesin dej unic unas pist dos man demasi cort caden cort	Terror
nuev york jack desgraci profesor histori emprend busqued sant	Comedia
sufr tal dej inclus miembr dur ciud tod prueb terror habil enfrent nunc jef unid jimmy enfrent mortal consider part pas inici tan personal desesper	Acción
nac interpret unid com amenaz muert president acus pais dias dar agent encarg proteg comienz sospech motiv	Crimen
año polic utiliz asesin comet crim futur pued deten unid pued prueb bas tres ser cuy asesinat nunc	Acción
trabaj vigil jef quier caus continu pued hac cuent director qued plan envi expert fin mund	Comedia
termin segund guerr mundial georg clooney guerr norteamerican vuelv berlin inform reun mism tiemp ve asunt intent ayud antigu amant cuy mar busc american	Drama
jimmy niñ comun logr escap centr ayud medi herman viaj haci niñ mism situacion decid acud concurs celebr angel descubr jimmy expert	Aventura
brown vuel necesit diner hac mafios busc polic parec ir bien dia sorprend acus trafic drog capital sol podr evit prision si acept polic ayud lleg	Crimen
gran futur alex jov dos pasion violenci jef band salvaj viol aterroriz poblacion terror lleg asesinat alex deten prision somet pretend cualqui	Ciencia ficción
vid bien cas acab ser sorprend novi cam intent perd vist angel tiemp march viv nuev york apartament amig dos peor ciud jef antigu ahor enemig cruz vid pretend veng muert hij asesin ide desencaden guerr band busc deb diner jef oblig mat hij	Drama
city ciud polic atract vigil desesper busc venganz cos univers her intent hac city ciud viv oscur llen personaj supervivient busc veng muert unic amor investig priv intent dej problem atras despues polic asesin par proteg amig final histori bruc ultim polic city va tras pist jov man hij result inesper	Suspense
ciud ocup japones señor muj ric sofistic recuerd com empez verdader nombr sin chi chi estall guerr mundial 1939-1945 padr huy inglaterr dej estudi conoc acab compañ chi chi convirt primer compañ part convenc grup estudi asesin señor import colabor japones chi chi colabor plan hac pas señor comet hac amig muj gan este suced segun previst inesper	Acción
call city hombr busc venganz trat cuent misteri muj traicion intent muert peligr mision acab mayor city proposit conoc jov	Crimen
detectiv georg busc sid rob muj encuentr muert man organiz hall preci	Crimen
dos terror huy polic hac años hij adolescent cad vez rebeld enamor muchach desconoc conviert amenaz segur padr	Drama
sigl comienz hermos final monj antigu acompañ relat acud nort intent resolv crim van desaparec misteri despues hall muert graci inform monj va hech parec ser antigu trat dic mayor mund asesin motiv muert victim nadi	Drama
jam kirk asist viaj ayud nav hall atrap deb capitan kirk decid ayud hall destru dad muert	Ciencia ficción
chic demas vist color haci madr mor padr dedic repent años descubr objet vid vid demas part entonc invent tod clas cuent existent vari person pas dias beb hombr vecin sol ve mund traves	Comedia
hac pas conoc famos ladron vez hac pas enamor rob aristocrat huy descubr casi año despues par rob diamant tal form contrat	Comedia
atrap enter muert doc brown deb viaj tiemp salv dos deb averigu com escap viej asesin	Aventura
clas hombr desafi rey histori sigl bas william wallac luch rey inglaterr despues brutal asesinat jov espos ingles wallac sol busc venganz numer wallac consig organiz ejercit guerrer libert logr recuper ello har libr siempr	Acción
ciud compañ obra ve oblig mientr espos actor principal empiez apuest	Comedia
capitan enterpris encuentr nuev intent imped histori conquist tierr sigl medi viaj tiemp imped prim vuel raz human prim contact raz	Ciencia ficción
capitan enterpris recib parec encontr estudi socied sufr existent equip investig habit planet pront descubr intent defend socied aspir	Ciencia ficción
polic capitan fabric llam final plan qued envi planet herman capital organiz golp graci fuerz nav nuev	Ciencia ficción
futur gran pais dirig man john tard tras qued nocturn jov rescat plen call misteri cuy nombr extrañ personaj plan combat libert part moment accion objet hac estall pais revolu gobiern	Acción
nuev york charli jov años trat mafi nuev york ve sentimient respons haci amig johnny	Drama
tension cuatr trabaj compañ estall peligr viaj transport	Drama
guerr provoc asesinat president pais call final terribl dos paul trabaj hotel empiez decid mejor refugi hotel haci alli organiz desesper acompañ sol famili sin vecin bas hech real	Drama
paul llev vid agent par decid abandon dedic instal vuelt par result paul vuelv mar sur acab obra	Drama
colegi priv nuev inglaterr grup alumn descubr import persegu sueñ graci excentr profesor despiert medi metod convencional	Drama
pertenec buqu escuel miembr sid asesin inspector llev investig muert deb cre sid tras rap muert ultim pelicul	Drama
dos cantant hac unid par encant dos mism objet cas millonari novi cuy padr contrat detectiv	Música
nuev york ver terror personaj	Comedia
prision año martin años puest libert tras años carcel anterior aleman berlin viv mur berlin prision ser liber entreg objet llev moment ident color azul conduc diner filmaffinity	Comedia
acab cas decid visit ancian march visit descubr encant maner practic	Comedia
deb ejecut mund public espi agent gobiern llam georg secuestr tres individu llev consig huir mat dia siguient regres cas acompañ polic person	Misterio
nuev aventur siniestr jigsaw hombr jueg aterroriz comun polic jigsaw vez consegu escap vez ayud nuev mientr polic local intent doctor sab punt convert siguient horribl jueg	Terror
decid rap aparec nuev victim asesinat jigsaw agent embarc investig permit deten asesin demasi embarg jigsaw ser deten sin part plan ocho victim jug vid ahor jueg	Terror
acud trabaj sesent años conoc dueñ bar invit bail habl acompañ cas dia siguient qued viv relacion provoc gran vecin visit propietari edifici	Romance
guerr fri amig acab escap agent soviet univers jim amig profesor ultim mision punt ser mientr conoc jov rebeld propon trat si ayud resolv problem personal cambi descubr histori encuentr lug agent soviet dirig fri bell mism objet	Aventura
sid envi futur mision mortal elimin sarah connor jov cuy vid gran import años sarah sol envi futur utiliz inteligent fuerz encontr sarah algun form deten aparent	Acción
fantasm abuel aparec hij cruz sol dueñ paul tia hij inclus vecin blanc viv abuel vuelt cab qued vid	Comedia
dos hij diferent ambos padr situacion complic averigu realid madr sol muert sin ademas local	Drama
tres joven jim cad alli motiv distint jim escap cas acab mat tir inspector descubr tres mantien relacion conflict famili jim van padr hij parej divorci visit cri negr viv	Drama
documental soviet realiz cont mejor aleman epoc documental bas vid dia ciud berlin	Documental
tiemp perd espos aristocrat ingles conoc jov compañ señor american jov cas van viv ingles pront señor da cuent pued mar recuerd espos	Misterio
jov realiz cin investig vid llam maner hero objet investig provoc	Drama
narr revolucionari veran mism año period amig comun verd deb cumpl mision destac result ser hij hero hombr	Drama
siempr des ser chic asi dia decid cort ocult baj cambi orden nombr pas llam filmaffinity	Crimen
dos band adolescent rival van colegi futur esper joven casi busqued socied ven camin facil violenci apen propi histori ley call relat convencional inclu inclus	Crimen
adapt novel profesor narr profesor noch va angel azul mal fam llev alli alumn acud local encant cantant embarg profesor años acab red part entonc vid humill	Drama
despues monstru cre doctor siniestr propon cientif compañer monstru	Drama
guerr cien años sigl despues hab conduc frances acus hab recib dios mision salv franci conden mor	Drama
bas histori real georg clooney agent pas tod vid trabaj medi investig cas terror años envi alli realiz mision dos empres american punt investig estadounidens	Drama
jam jov sueñ volv tiemp herman mayor dia lid rebeld chic ahor herman pues hac dos march cit	Acción
nuev york suen the the cos facil chic form band chic orig italian diferent band rival raz violenci camin resolv	Drama
banc parqu anim compañer alan ciud nort alemani ver espectacul doctor emple doctor aparec asesin dia siguient alan acud ver doctor ayud anunci alan viv	Drama
pequeñ puebl cuatr joven amig sal ciud busc chic desaparec chris extravag des ser vist her mism puebl emprend dos dias conviert aventur escond cuent histori gust hac caus comun cos pon encuentr maton puebl armad busc cuerp chic descubr fuerz nunc	Crimen
chic viv mund fantas cancion sueñ azul algun dia liber famili amig esper lleg decid ciud busc mayor exit cin	Comedia
principi años joe jov encuentr trabaj muj tard joe encuentr cuerp muj aunqu polic sospech hac cad vez joe sab muj dic investig asesinat fond joe embarc aventur intim	Drama
don corleon conoc dentr cinc famili ejerc cos nuev york años cuarent don corleon cuatr hij chic tres michael negoci empiez luch violent distint famili crim organiz	Drama
epoc ley joe dos music ven oblig huir despues ser testig cuent dos band rival encuentr trabaj mafi decid vest mujer joe conquist kan cantant grup ser mientr millonari quier cas	Comedia
continu corleon dos histori michael corleon jef negoci familiar don primer unid empez lleg ser jef mafi nuev york	Drama
convencional parej joven amant nac mat dos despiad criminal poblacion present aprovech personal ejerc public conviert asesin her	Crimen
michael corleon hereder don corleon intent tod famili negoci despues luch tod vid encuentr centr tod esper encontr carg negoci vincent hij herman parec ser eleg	Crimen
comedi rob gordon dueñ tiend disc chicag cuy vend disc rob dic ser verdader music pas tiemp dos emple dos tip aunqu tres conoc fond mund music popul encant conciert ide hac cinc mejor cancion tiemp rob pas mal moment relacion novi romp part moment rob empiez amor llam cinc principal dec chic dej vid dej lad music pasion vid junt mujer	Drama
equip cin va rod pelicul misteri isla alli descubr existent secuestr atract protagon ofrec gigantesc	Aventura
will años viv autor cancion hac años padr mied tal sol relacion madr facil romp embarg conviert mejor amig niñ años conoc cit	Drama
sigl vagabund viv jueg dar ademas espad rap mejor ciud band amig conoc par bell peligr herman lleg ciud veng asesinat padr unic pist misteri nombr	Aventura
despues pas carcel johnny decid dar ultim golp vid permit retir junt plan llev carrer caball despues colabor asalt trat provoc sal apuest mat caball carrer cuent ayud polic georg apuest atrac desarroll segun previst problem present	Crimen
epoc ley dav alcohol punt trat import mafios chicag anni siempr dad envi hombr busc oper anni complet desesper hij ve hac años lleg europ acompañ novi aristocrat italian anni convert gran	Comedia
matrimoni perfect tan result vid tan produc espos madr cas perfect aleman complet famili cuent dese propi ident	Comedia
emple banc acab dej novi hab deten ladron intent atrac banc trabaj sol golp amenaz muj ladron acud cas buen accion ahor van pod form famili decid plan atrac diner parej ello unic conoc herman trabaj cont ayud tres emple pet martin embarg sal previst final cuent filmaffinity	Acción
parej enamor ve asesin ladron neces salv vid chic hac tierr form fantasm intent peligr corr unic medi comun	Fantasía
excentr dueñ gran fabric dia decid ofrec cinc niñ permit fabric charli niñ pobr buen corazon esper futur mejor madr cuatr abuel result ser cuatr niñ	Familia
tan sol hor tres agent servici secret britan investig red trafic drog aparec asesin extrañ tod pist conduc llam agent jam envi nuev york investig personaj	Aventura
cambi conoc carl luch camin mund espectacul une jack autor tres emprend viaj llev isla previst dirig pelicul alli descubr ser habit criatur viv ocult millon años ve fam pued captur nuev york	Aventura
continu antoin tras golp protagon tras ser expuls ejercit visit antigu novi christin padr christin encuentr trabaj antoin vigil nocturn hotel embarg detectiv priv pierd emple prim dia detectiv ofrec trabaj principi antoin encarg asunt mision averigu tod emple señor georg antoin conoc espos propietari	Comedia
segund pelicul realiz personaj antoin sig tras golp realiz	Comedia
niñ pas desesper decid habl asunt director eleg expuls centr ofrec quier contrat despues trabaj ayud escap lleg londr ciud conoc ofrec entonc ver oblig trabaj malv dirig band chic	Crimen
antoin christin parej cas mientr gan vid vend flor call par muj clas pas tiemp beb antoin sig siend hombr aventur	Comedia
tras cinc años matrimoni hij antoin christin divorci trabaj enamor tiend disc dia encuentr alli jov conoc antoin prim amor antoin encuentr conoc madr tod mujer pas vid	Comedia
repent suen comienz medi chic pregunt si pued ir acced llev apartament	Misterio
muert ancian famili sur desencaden terribl tension hereder hij refugi alcohol complet situacion muj dispuest espos ambici oportun	Drama
comedi narr histori obsesion convert mejor camp dia conoc oportun aparec este embarg consig quier final ayud amig secuestr pod consegu proposit	Drama
vuel sal angel destin chicag encuentr seri personaj combat plen vuel ver oblig hac tras qued com mal	Comedia
dos norteamerican dav jack viaj europ camin zon inglaterr poblacion local mir mal bar sal recib tip extrañ aun asi joven oscur cuent siend segu terribl criatur	Terror
histori cancion segund guerr mundial lleg convert primer despues band ali music años atras sold aleman tres años tard disc bell cantant exit tal servici decid hac cancion	Drama
paul autor frances acept pelicul va rod baj director aleman prim encuentr norteamerican jack escritor dej muj bell coch este da lug grav mal escritor espos cre ofrec cambi obten mejor pag consecuent situacion escritor ver	Drama
noch victor chic fortun acud busc pis despues hab conoc encuentr alli dos polic armad produc suen par dav agent qued siempr cambi vid acab cas victor va par carcel sal obsesion acerc desencaden mezcl amor violenci	Drama
hab vist mor padr bruc wayn cad noch batm terrorif form gotham city combat crim manten ciud vez batm enfrent terribl enemig pretend somet tod ciud baj dese	Fantasía
cin tras rob coch ir par mat polic algun acab hac viaj par tras rob diner amig busc jov burgues american aspir ser escritor vend york camp sueñ algun dia period europ cre hab hall libert conoc polic busc muert	Drama
nuev jim cas asesinat president unid john present carg person despues numer testig person relacion hech podr hab fbi propi	Drama
viv padr encuentr nuev compañer jueg oscur dos desiert desafi peligr famili descubr jug junt volv hech padr jef ladron enemig ahor dos niñ valient deb intent manten famili tiemp	Aventura
cambi hombr mund pregunt obsesion bruc wayn fantasm padr muert tir call gotham noch vid siempr hereder desaparec gotham viaj secret mund busc medi luch utiliz mied aprovech mied ayud detectiv jim gordon poc buen polic fuerz orden public gotham ali wayn enterpris bruc wayn liber alter batm utiliz fuerz inteligent alta combat fuerz siniestr amenaz destru ciud	Acción
miembr cuerp vigil armad especial llev tiemp plant trabaj parec convert maquin mat noch miembr organiz terror jov	Animación
fbi busc bill asesin seri mat victim tod adolescent despues prepar pod atrap brillant expert aspir form part fbi jef jack visit carcel alta segur gobiern mantien encerr antigu asesin dot inteligent superior mision intent sac inform bill	Crimen
hombr tim cas hij millonari impid disfrut fortun decid contrat dos delincuent secuestr muj fin mont negoci propi diner rescat seri secuestr tres brutal asesinat oblig polic	Crimen
pet jul juli disfrut rebeld une pasion cambi mund conviert the cuy accion violent trat ric local dias cont complic aparec jul enamor ambos joven ademas oper complic conviert intencion acab pon car car ley	Drama
sigl dos raz profund tierr aristocrat sofistic vampir brutal cuy existent siempr form part mund mit raz nocturn enemig mortal conden viv guerr sol medi conflict guerrer vampir descubr secuestr michael jov medic despues segu tod ciud relacion decid atac medic mientr intent salv michael descubr plan cre nuev criatur poder raz hac realid	Fantasía
acus asesinat muj tras ser conden caden envi prision pas años consegu gan director centr compañer especial red jef mafi	Drama
music destac cort entreg complet music dios si cambi dot despues lleg cort jov llam qued segund plan perd protagon har posibl carrer jov music mientr maquin sorprend music excentr	Historia
pas once años sarah connor marc objet ser elimin futur ahor hij john futur lid resistent objet modern vez resistent envi vuelt pas intent salv john madr sarah	Acción
dos dias lleg año call angel gent sid expuls dedic client vend person	Crimen
asesin niñ tod ciud polic busc desesper deten cualqui person sospech part jef red sufr asesin decid busc mism	Drama
intent sobreviv viv cuy dueñ maltrat consig reun diner pag habit unic amig mund jov cri perr	Drama
ambici emple compañ segur viv sol apartament superior cit amor esper mejor empres situacion cambi enamor result ser amant jef apartament	Comedia
suced hombr muert encontr her will ali capitan busqued desesper liber capitan jack man mientr terrorif fantasm baj control compañ caus larg siet mar will medi traicion mar salvaj deb segu enfrent ahor tierr deb eleg band batall final sol vid fortun sin futur clasic	Aventura
vid narr histori famili muj dos hij años cuarent realiz epoc gran polit golp mayor cin filmaffinity	Drama
viej amor atract anim equip cad anni equip educ cam camp jueg dos veteran ambos suced siempr decid filmaffinity	Comedia
will kan pequeñ puebl acab matrimoni cas traslad ciud abrir pequeñ negoci repent empiez corr puebl notici frank criminal kan atrap llev sal carcel lleg puebl tren veng kan tiemp va pas nadi puebl dispuest ayud	Western
segund guerr mundial ciud lleg gent tod part lleg facil sal casi especial si nombr principal objet polic secret aleman lid hero resistent victor cuy unic esper propietari antigu amant muj ofrec qued cambi sac pais deb eleg propi rig vid pas	Drama
viaj wallac vez instal hotel sufr mental vecin habit segur trat ayud seri hac cad vez trabaj	Comedia
documental relat primer comienz sigl desarroll larg cost part años	Documental
quier hac fiest amig music decid metod antigu convencional invit personal vecin señor niñ escuel conoc television quier barri	Comedia
aunqu norm paul hij recib rig educ disfrut libert norm jov profesor enamor paul cambi dedic period llev vid pes siempr unid salvaj aprend	Drama
bell profesor ingles matrimoni futur lleg divorci maner rap alli conoc chic trabaj casin pas cad vez tiemp junt vuelv viv nuev	Drama
novel viaj tren jov jov conoc vid traves inesper propon asesinat victim fin asi podr resolv problem muj quier divorci cambi deb asesin padr este gran fortun viv	Crimen
pas dec john connor salv human john años viv ningun prueb documental existent asi evit ser sofistic maquin vez intent acab vid ahor futur sid envi maquin desarroll mision complet trabaj termin maquin tan bell aspect human ahor unic esper sobreviv	Acción
william poder cuy vid ve alter lleg jov llam joe enamor hij trat realid muert mision cumpl muert	Fantasía
danny oce band sol razon realiz golp ambici defend despiad propietari casin nunc imagin pon traicion amig danny oce desgraci miembr band dej demas proposit compart noch gran nuev casin	Crimen
once amig compañer armas guerr mundial 1939-1945 plan rob sol noch cinc mayor casin veg año gran georg clooney juli	Crimen
jov tim propi sueñ siempr trat control imagin amenaz mund real vid present oportun cambi madr frances convenc vuelv cas natal par trabaj grand trat trabaj pequeñ compart tres compañer especial excentr embarg desaparec conoc vecin charlott amig	Comedia
john wayn asesinat herman poder cuy hombr intent liber imped cuent colabor dos ayud alcohol martin viej walt une jov habil llam color qued encerr carcel tension puebl esper lleg autor llev deten	Western
sarah charlott escritor britan autor libr misteri novel viaj londr sur franci pas dias cas charl intencion encontr nuev novel alli conoc hij adolescent atract convencional juli	Crimen
tras segund guerr mundial 1939-1945 padr espi conden traicion unid despues da fiest aparec apuest desconoc llam trat agent servici inteligent colabor atrap cerebr nazis principi final acced enamor atract agent american vez gan va viv cas asunt acab pon peligr vid	Suspense
ingenu emple banc enter aprovech jef humill sol perr parec ser capaz amig charli invit ir intent consegu ocurr aparec bell entra banc habl pas cam entonc encuentr da grand poder mied ahor libr quier	Romance
sold american envi mision unid fin salv vid result principal objet mision captur acab guerr principi parec ir bien dos aparent entonc mision conviert desesper carrer rescat tripul sold tierr qued atrap result her accident	Acción
detectiv emple persegu despiad asesin ayud viej compañer investig conduc popul parqu angel alli conviert nuev lug bien qued rescat niñ enorm azul	Acción
segund guerr mundial 1939-1945 ocup nazis trat lid liber anni ofrec refugi cas aleman descubr rod consig escap	Drama
extravag mit don despues ser abandon ultim conquist don bill recib cart inform hij tan inesper notici emprend viaj busc antigu amant resolv misteri	Comedia
famili alta burgues dispon celebr sesent cumpleañ hombr embarg tres hij aunqu diferent dispuest aprovech sac famili	Drama
tras pas peor vid bruc consig pod pues dios ide llev asunt tal dios decid poder ver si capaz hac mejor	Fantasía
dav noodl pobr jov judi conoc suburbi principi sigl nuev york max jov orig dispuest lleg cualqui metod gran amist form noodl band rapid desgraci persegu tip noodl amig trabaj anterior asalt mat rapid noodl tir mat pas años prision noodl sal prision recib max sig band junt amig rapid lleg convert tiemp mayor pais	Drama
andy niñ seis años lleg hor nuev cumpleañ corazon dueñ sid ahor andy trat aparec hero dot tip segund rival transform gran amist ambos pierd ciud sab com volv cas	Animación
alex ingles lug dia emprend viaj visit madr hij muert	Romance
hall muj siempr dispuest gent trabaj gigantesc dirig georg espos enter siniestr secret revolucionari pront va sal ve entonc salv muert fuerz gat nuev vid venganz misteri muj llam	Acción
tres chic tras dur noch trabaj gust mont coch pis fond busc problem asi medi desiert encuentr jov parej carrer acab mat secuestr continu encarg cuent medi desiert viv dos hij viej escond enorm fortun dud chic dirig cas averigu diner filmaffinity	Acción
chris cas segund propietari pequeñ restaur pas cas cuatr viv ciud tan antigu alemani chris intim amig amig intim impid buen dia chris aventur ser har aparent perfect univers pequeñ burgues dos parej mism tiemp hech invit cuatr existent error pas aprend dese descubr pequeñ volv viv final result ciud tan pued cambi	Comedia
quier hij doc años oportun viaj organiz colegi prob padr mur guerr sal mit preci siempr da larg pid parec tierr encontr diner pag preci viaj convenc proteg mism hij si cuent verd	Drama
band viv angel hotel millon tom protagon enamor muert har padr import personaj television march investig suicidi podr	Drama
jov solitari celebr cumpleañ siempr hac pelicul cin hac sal surg aventur amor llev dos joven viv verdader noch pasion realid prostitut mejor amig cumpleañ dos joven enamor matrimoni intent alej muj enfrent ir abrir encuentr consider utiliz esper realiz sueñ	Acción
will dorm veteran detectiv angel viaj pequeñ puebl compañer investig asesinat chic años angel qued oscur asunt dos vez contact principal sospech walt novel	Crimen
jov intent viv novi padr enter	Comedia
jimmy dav tim niñ junt peligr barri pas dias jug call dia dav ocurr marc siempr vid amig años tard vuelv asesinat hij años jimmy polic cas jimmy desesper intent tom man	Suspense
principi sigl narr histori adolescent negr años propi padr hombr part entonc vid llen humill	Drama
divorci espos hij rey catol tia carl matrimoni trat obten mor gran human catol hombr encuentr ser ejecut deb rey ningun adapt ley neces	Drama
encuentr tren antigu amor capitan larg rod grup personaj llen inclu asalt tren grup rebeld cuent nunc dej	Aventura
agent fbi testig angel intent testig asesin liber plen vuel agent fbi tripul aterroriz intent sobreviv mortal	Acción
viaj angel encontr herman pequeñ proteg criminal lleg alli descubr realiz unas oper trafic drog demasi futur decid ayud com tom baj fond angel mafi japones dec maton profesional bas accion mental criminal norteamerican	Crimen
director bas novel convert pelicul aleman pelicul cuent histori escritor estudi escuel despues amig perd gran vid educ cas	Comedia
john ide espectacul parqu isla retir visit pued observ real ultim desarroll cientif pued utiliz ello sangr hac millon años alan visit parqu qued sorprend result obten emple sofistic segur escap oblig visit luch	Aventura
pas cuatr años devast parqu punt descubr sobreviv isla cost ric cost cinc muert viv libert trat llam zon lug despues john llev empres pet tom dispuest compañ peligr zon	Aventura
doctor alan consegu fond estudi inteligent acept parej millonari paul isla puert ric cre parqu tras produc isla alan descubr busc hij adolescent perd isla tras accident	Aventura
john brown segur sueñ ser mejor agent polic mund camin malv dad muert cuerp facil utiliz brown despiert transform inspector maquin perfect prepar luch crim bas seri anim años especial	Acción
jov ric desesper consegu famili dej vid priv des cabez dej parec decid ello herman ademas recib padr dese cas jov cantant famili dia desesper conoc bar muj compañ ve problem contrat hac ver novi filmaffinity	Comedia
pelicul nuev lug san angel niñ prodigi present concurs television prodigi hij perd muj histori aparent independient extrañ relacion vid american vist traves seri	Drama
mientr desiert camin haci mar lleg pequeñ puebl intencion empez nuev vid	Drama
john veteran conoc plan trabaj junt rob banc dia cre banc local result ser prision liber revolucionari pres ambos conviert her revolu tiemp despues gobiern comienz segu pas	Western
par años sesent adolescent judi independient viv padr barri popul amist señor ancian propietari pequeñ tiend	Drama
berlin dias mur madr alex muj ide comun entra com despiert ocho despues hij har posibl enter viv alemani capital objet convert apartament famili isla pas madr viv cambi	Comedia
pelicul histori independient traves jim present nocturn cinc grand angel nuev york par ocurr mism dia diferent personaj	Comedia
jov judi norteamerican lanz busqued muj aparec junt abuel pequeñ puebl natal	Comedia
vid vincent sol volv ten dia asesin muj deten vecin alic convenc pued decid invent vincent pued veng dej atras pas	Crimen
amig hac años equip celebr numer pas esper gran trat veran dej ser niñ vuelv seri da cuent sentimient profund quier cad vez lug equip tan esper lleg equip joven hac repent compañer ven oblig mied sab si dese secret med tension muchach parec tan violent amenaz	Comedia
comedi negr relat histori jov buen famili obsesion muert punt prob diferent metod suicidi	Comedia
viaj chicag nort reun nuev famili polit desafi asi cas clas medi sur	Comedia
william medic cuy vid parec ir bien cas muj hij trabaj gust dia siguient asist fiest espos alic habl unas fantas com punt romp matrimoni desconoc acab local antigu compañer habl secret dedic limit part entonc mund	Drama
band habit pequeñ puebl period ataqu decid contrat final consig servici guerrer dispuest defend cambi tan sol com	Acción
pelicul documental intent vid berlin ello utiliz pequeñ histori dos hombr dos mujer pas ciud	Drama
regres tierr nav carg viaj despiert siet tripul orden madr misteri form vid desconoc planet aparent nav dirig entonc extrañ planet investig orig comun	Terror
obra tragic histori jov viv barri encuentr atrap violenci padr beb maltrat testig ello jov enamor trat ayud	Drama
mund mod nuev york sant dirig eleg trabaj quier mund hac ayud podr cualqui puert andy chic destac dentr pequeñ ejercit andy pront negoci va necesit inici prueb vest cabez	Comedia
pobr vagabund charl pas mil consegu diner ayud pobr chic enamor	Comedia
perd malv pues razon niñ ciud rob sueñ compañer cerebr dentr band lad ciud encuentr fuerz ingenu valient busc herman pequeñ desaparec	Fantasía
sid conden dos años trabaj romp plen vid conviv pres conden grav ademas violenci pres convert habit veteran guerr dispuest pag preci segu siend	Crimen
jov segund gener imagin gran bruc lee cuy sueñ ser prim director pelicul alemani deb rod restaur conviert celebr barri embarg vid dar gir novi aleman comun padr cas madr futur ademas ser padr ten cambi asi dej sol qued asunt cos march bien	Comedia
muj ambici hombr atract aprovech encant peligr obra mayor joy cin adapt obra	Drama
miembr encuentr tia herman jack enamor famos jam punt matrimoni jov dud utiliz consegu dej encant sal segun previst despues verd poder pid ayud extravag señor romp tia tom cart asunt intent utiliz poder reun parej amor	Comedia
revolu guerr produc pais medi conflict asist intim hombr luch sobreviv hombr mar amant cuy vid guerr vid inclu tony muj muj enamor	Drama
pobr niñ rob com vest muert pod sobreviv dia mientr huy niñ rob encuentr dios hac convert hermos princes tip volv pas cambi podr encontr amor verdader pues cualqui hombr termin dias maner tragic demasi acept trat años pas tom pues tal dios hombr termin sufr	Fantasía
año matrimoni san cuatr preci hij años enamor vecin acab instal ciud embarg famili especial enorm padr anunci deb traslad viv nuev york motiv trabaj	Comedia
detectiv investig ocurr sid rescat lid famili contrat resolv cas hij atract enamor	Crimen
comedi control casi absolut ser protagon actor firm kan realid complet casi personaj gran public actor da vid atrac banc part nac carrer detectiv practic pes pues inclus intent filmaffinity	Comedia
millonari hombr hech mism vid llev huir prep golp perfect rob banc march despues reun grup delincuent tres millon banc da golp dej pist cas ocup investig compañ segur	Crimen
despues hab intent suicid cuarent años alcohol sid plant consig dorm drog alcohol chic años nac gust demasi vid ser buen intent suicid huir carcel human famili tradicion vez suicidi sol ve liber famili cas	Drama
gotham city enfrent dos nuev criminal siniestr criatur solitari hermos batm enfrent quier convert ciud	Acción
jov profesor acab qued quier empez nuev vid hij puebl natal mar busc tierr prepar valient vid tod futur nuev aparec vid filmaffinity	Drama
frank detectiv polic san francisc ambici polit encarg crim chicag embarg pued evit asesin part moment deb investig cas hall misteri	Acción
ahor ancian muj recuerd pas vid cas famili trabaj dur pag mar pierd accident famili cri sol niñ filmaffinity	Drama
walt ejecut trabaj dedic tiemp vid priv dia necesit acompañ ir negoci client japones herman propon ir acompañ nadi chic nuev ciud	Comedia
nuev raz vampir surg oscur sangr busc nuev victim guerr vampir human estall organiz secret sid mund amenaz mejor agent encuentr misteri muchach llam cuy fri conviert mejor cazador vampir	Animación
aspir carrer rap exit fam error tom inesper solitari lleg pequeñ comun cos import vid	Animación
bas histori real despues hab retir jam decid volv años gran pod famili talent llev	Romance
william decid abandon puest despues recib trabaj ciud embarg lleg result puest ocup person charli hij propietari empres mat muj encuentr cam vez charli mod conviert persegu tres cazador	Drama
hac muert convert ser human lleg punt vari qued practic desiert supervivient deb refugi zon dud acab propi familiar continu clasic georg noch muert the	Terror
clasic georg poblacion planet convirt muert horribl continu busc sangr human sobreviv grup person escap trat salv vid refugi centr deb aprend sol proteg sin conviv	Terror
barri conviv vari famili raz negr parej famili chic trabaj testig personaj hech lug barri asi tension habit	Drama
seri television gran exit años vez dej protagon dedic pas antigu especial sab raz alienigen seri trat luch decid secuestr protagon ayud combat	Comedia
vari joven pequeñ local pesadill persegu hombr termin comienz ser asesin mientr ser result ser asesin padr joven viv hac vari años tras descubr asesin vari niñ	Terror
parej pued ten hij dispuest form famili decid secuestr beb famili acab ten	Comedia
año dos amig surg gran rival caus amor muj ciud tom enfrent guerr desencaden traicion conflict polit	Drama
charli jov corazon esper recib consider tras muert padr embarg charli absolut cuent herman mayor medic recib tod fortun mental limit aspect dot	Drama
pes john gat ladron joy conviert principal sospech seri rob preci lujos hotel frances asi conoc hereder ve oportun misteri ladron utiliz joy madr jov	Crimen
prim produc alemani tras segund guerr mundial cre estudi hombr muj regres berlin muj supervivient camp pes sufr dese vid regres apartament encuentr viv medic guerr	Drama
prim larg van sant rod blanc negr cam apen walt dueñ tiend enamor johnny jov habl ingles aunqu walt johnny acept dorm diner filmaffinity	Drama
despues cumpl cinc años conden tony sal prision intencion cambi vid encuentr antigu amant conoc asi cos qued volv vid pas reun viej seman prep golp perfect atrac joy par	Drama
convenc comun unid orden ataqu soviet ayud capitan trat encontr imped part president pon contact convenc gobiern soviet ataqu error mientr estadounidens antigu cientif doctor existent maquin final soviet capaz acab human siempr	Drama
princes lleg joy form lujos hotel conoc eleg charl dav baj cuy ocult embarg despiad ladron profesional conoc fantasm imped delincuent encarg inspector polic frances famos pet	Comedia
aleman segund guerr mundial grup joven sold dispuest defend somet dur tras descubr sid envi realiz mision	Drama
enfrent dur polic inteligent atrac secuestr banc segun desarroll peligr jueg gat aparec person sid contrat propietari banc trat poder secret	Crimen
tras prueb present popul doc hombr decid si conden muert jov acus hab mat padr principi once complet convenc conden empiez plant dud razon van segur demas	Drama
cin recib amig moment rod pelicul deb europ encontr ayud	Drama
tras muert terror joe vagabund lleg puebl san dos famili control entra servici noch joe testig armas sold	Western
puebl frances cambi ultim cien años nort llev consig dos hij ocult habit puebl ademas don especial permit dese demas	Comedia
tras elimin miembr band intent asesin dia bod negr venganz intent acab rest band especial antigu jef bill muert dej com	Acción
parej polic form martin vuelv carg enfrent mafi angel investig ayud jov polic respons cabez familiar dej hij cas cos complic compañer esper hij amenaz hac pas	Acción
descubr antigu baj hac acud equip cientif vez alli hac descubr aun dos raz guerr gan gan perd terrorif aventur comienz millonari charl reun equip cientif expert segur dirig especial alex investig unas misteri surg profund	Aventura
georg matrimoni salvaj ambos personal conoc perfect sab com georg profesor histori alcohol hij director univers georg da clas muj sab noch despues fiest invit cas nuev profesor espos parej evit georg humill maltrat traves jueg sal verd invit	Drama
chic convencional sueñ cas novi charli ser siempr problem charli enamor bell frances viaj negoci par dispuest recuper vuel capital frances conoc ladron parec ten comun situacion complic cuent rob sab com ve viaj tod franci descubr junt encant pais	Comedia
pelicul escritor investig realiz sangr fri libr bas hech real gan mejor actor interpret	Crimen
expert ladron viv pued si cos complic band form criminal profesional tan pued inclus detectiv vincent viv tan obsesion trabaj lleg inclus pon peligr relacion band prep golp equip intent evit cad brillant enfrent carrer	Acción
jimmy retir sant nunc mat hombr eleg armas jimmy viv existent tranquil ciud buen dia recib visit antigu jef este hombr plan propon ultim trabaj dar chic mantien relacion hij llev cab jimmy reun viej pierd cos acab mal	Drama
vuelv cas natal nuev despues diez años asist madr alli pas conoc chic pued cambi vid acab dej tom años comienz mism inclu enfrent padr ayud propi problem	Comedia
antigu cantant rock sid brutal asesin ultim vez acompañ novi asunt recib encarg vigil novi asesin	Suspense
profesor años decid coch hij posibl peor aun accident contrat negr principi ancian tranquil llev demasi bien	Drama
ancian viv hij ademas sufr perd grav problem casi impid recib notici herman hac diez años sufr pes decid ir ello hac unic medi transport dispon maquin	Drama
artist herman muj madr chic resistent pes violent muchach vid siempr call italian dueñ inclu espectacul aunqu vari personaj va conoc propon ultim consecuent	Drama
tras noch suburbi par tres joven amig esper notici amig comun result her enfrent polic	Drama
junt amig bobby cost tiemp form pequeñ delincuent embarg decid cambi vid sal empez trabaj empres herman bobby cambi relacion mafi cost continu rob coch sueñ abrir ide alic novi bobby problem surg pid bobby alej baj fond intent unic consig recib brutal embarg inesper situacion dar	Crimen
malv princes decid pued jov superior embarg consig salv refugi siet pes consig encontr princes muert sol dorm esper azul rescat	Fantasía
final segund guerr mundial hombr her viaj tan grav qued encarg cuid cuerp consecuent accident sufr tiemp cont tragic histori vid	Drama
veran berlin dos amig viv cas antigu berlin pis pas noch enter charl viv hij plant baj tierr instal observ existent hombr acerc propi vid dese	Comedia
histori narr aventur cuatr herman pet segund guerr mundial descubr mund acced traves magic mientr jueg cas camp viej profesor descubr mund habit animal habl conden ayud niñ luch pod blanc ejerc espectacul batall consegu asi liber fri	Aventura
aventur solitari vari personaj enamor hermos trat conquist	Aventura
detectiv priv misteri muj dic amenaz hombr encarg aparec muert parec gir	Misterio
ciud gotham amenaz nuev vez trat parej dos car alter mund enter siempr motiv bruc wayn deb vez batm luch vez sol acompañ jov	Acción
experiment convert victor fri malv necesit manten cuerp ello intent habit ciud gotham lad tim transform experiment terribl asesin ser human tierr plant recuper planet motiv batm deb enfrent deten siniestr plan	Acción
band atac cad año tierr vari decid busc hombr pued defend consegu reun siet hombr cad especial	Western
haci año llam vend escuel combat pront maltrat sufr	Historia
delincuent poc mont decid atrac banc embarg deb rob sid plan ser ejecut apen diez minut conviert tramp atrac espectacul television	Crimen
jov viv vid tranquil muj cas lad mund sufr revolu aparec nuev vecin jimmy asesin despues prision jef mafios intent ahor empez nuev tranquil vid embarg espos acab sueñ oblig este chicag mafi jimmy asi har cualqui cos alej muj acced llev cab plan asi podr reun diner abandon desaparec	Comedia
cuatr histori gir matrimoni filmaffinity	Comedia
tras prepar plan veng muert man blanc bill tripul inclu espos period jov podr ser hij	Aventura
despues obten exit director cin intent hac nuev pelicul situacion empiez pas hech import vid tod mujer	Fantasía
orig judi interpret mientr aleman capital pais hac pais llev cab mism polit judi asi tod famili padr herman dos ven oblig dej cas pertenec traslad mil person orig judi mientr trabaj restaur judi colabor nazis herman luch nazis tres años tard habit traslad tren haci camp	Drama
hombr enorm talent relacion public organiz ambici plan gan nazis despues aleman consig graci relacion nazis fabric alli emple judi cuy hac rapid judi verdader director pues conoc	Drama
hac años pequeñ nombr escond hac provoc provoc animal haci sur haci tierr buen dic llev trat solitari vagabund va haci nort sol demas haci sur	Animación
detectiv polic san francisc compañer mientr delincuent decid retir viej amig colegi contrat vigil espos bell muj obsesion pas	Misterio
barri modern organiz viv espos hij lleg personaj llen fantas alter mund tan tard convert mejor amig	Comedia
cuarent años segur tan mar cas veran ningun vid compart novi hij años invit novi doc años pas ningun problem empiez bill hombr mayor decid acab relacion	Drama
guerr tres cazador lanz busqued ningun tres pued ayud dos sab encuentr mientr joe conoc nombr escond mientr dud mat mujer niñ consegu form tres hombr colabor final intent elimin	Western
destin berlin recib encarg cuid hij jef visit enter chic escap matrimoni jov comun jef vuelt tan sol hor qued transform revolucionari pued tard dec dos tres plan escap man provoc capaz aleman peor propi espos	Comedia
seis person desconoc despiert dia encuentr atrap prision extrañ fin habit dot tramp mortal polic ladron profesional prodigi estudi matemat jov mezcl personal ningun sab com lleg alli pres surg obsesion grup huir sal tan horribl carcel mientr vari pregunt pod cre encerr objet	Suspense
grup sold baj marc sufr guerr captur ejercit enemig despues recib gobiern unid entonc marc comienz sufr terribl pesadill relacion cerebr somet	Suspense
famili ingles form padr madr dos niñ rebeld pretend llam padr hac vid tod ver alter lleg especial emple juli clasic cin famili dia magic cancion pequeñ cas	Comedia
harry dur polic cri call compañer llam harry metod luch crim siempr encarg trabaj san francisc mat dos person harry encarg resolv cas	Acción
investig jack hall podr desencaden cambi tierr hall polit neces med evit lleg demasi tard seri empiez produc distint part puest planet bord nuev mientr jack cas blanc cambi hij sam amig encuentr atrap nuev york concurs	Acción
mar jov años pequeñ poblacion nort blanc trabaj gran prepar flor unic mar bail acud cad fin seman novi dia famili abandon trabaj decid nadi sospech mar viaj encuentr conoc habl trabaj trafic drog convenc amig blanc band	Drama
ocho person despiert encerr extrañ habit form cub sab com lleg pront descubr ley extrañ mund asi descubr secret cub pod sobreviv	Suspense
cub despiert habit perfect llev extrañ man recuerd nombr pront encontr mism situacion med van cub mur tramp encontr secret trat form part grup observ cuy trabaj control grup intent hac algun cos ayud univers cub nadi salv observ observ huy busc sal sab llev	Misterio
period busc celebr fiest nocturn celebr burgues epoc distint siempr rod tip personaj especial socied italian sal enter celebr mund cin lleg cre gran oportun consegu gran notici consecuent persegu noch diferent ciud	Comedia
nav estrell aparec puebl color bord escap mat ultim supervivient deb ahor acab asi terrorif anterior entreg mientr habit puebl siend atrap medi ultim enfrent dos criatur	Fantasía
cientif descubr hombr nac cri salvaj mientr cientif intent educ amant luch hombr segun libert medi luch pod surg amor	Drama
pelicul mund cin sueñ ser detectiv encuentr dentr pelicul alli intent salv cin llen	Acción
escritor novel ademas pasion jueg llev convert gran extravag tard invit cas mil amant muj propietari caden propon plan ambos podr sal	Misterio
american dav viv puebl muj gran hombr tim viv investig evit cualqui embarg violenci individu puebl lleg tal espad par mism armas defend muj obra perr estudi violenci ser human bas novel the gordon	Drama
georg burgues present television llev vid muj hij adolescent empiez recib call cuy misteri sab envi embarg aparec hac cad vez personal conoc hac algun tiemp georg amenaz famili puest algun polic ayud	Misterio
sol dos dos pais sin dos mund diferent dos form viv grup person llen buen intencion luch encontr camin mund viv oscur	Drama
sam herman mayor michael joven american instal tranquil ciud sant carl cos misteri empiez cambi personal michael transform madr gust ver convirt	Terror
dos rebeld adolescent amig hac años sab com pas ahor acab estudi pes tim encontr trabaj acab call comport gent personaj excentr mir anunci personal period local llam autor anunci hombr solitari cuarent años disc invit cit acud restaur espi sab com vid	Comedia
suburbi par cam sig grup chic viv batall trat mir nuev suburbi frances unas violent puest socied frances	Romance
april jov modern años famili burgues instal apartament sid nuev york compart novi color bobby dia accion graci april invit famili nuev cas pas present bobby april nunc llev especial bien madr joy bobby convenc invit si prepar encuentr april descubr bobby misteri desaparec jov busc apartament edifici mod april comienz conoc vecin entonc desconoc filmaffinity	Comedia
alcohol cuy vid decid veg ciud bar nunc beb mor alli conoc ser prostitut acept enamor histori dos person aprend acept com medi oscur pued surg pequeñ llam esper vid	Drama
grup amig reun intencion liber socied individu ello hac pas mental grup dedic enfrent socied	Drama
obsesion busqued ide matemat brillant estudi john lleg realiz estudi muchach extrañ solitari sol compañer fin revolucionari consig profesor mit alumn dej ley amor matemat graci prodigi habil william ayud unid guerr fri soviet	Drama
suced enfrent dos famili poder cuy objet consegu ciud organiz fiest asist graci amig pretend jov hij dav hij mir surg prim moment amor adapt modern clasic	Drama
jov orig viv famili inglaterr padr des termin estudi cas deb tradicion pais orig chic sol sueñ dav pas mayor part tiemp jug jov ingles jul invit equip inici bell amist gran aventur	Comedia
socied ofrec gran pelicul centr vid años	Drama
francisc deb cas aunqu madr jov princes enamor sissi jov convencional cort pes cont madr jov enamor har bod sissi primer famili	Comedia
tras bod sissi empiez nuev vid pront conviert verdader problem nac profund estall cumpleañ hij sissi antigu tradicion cort niñ cri madr final lleg sissi podr educ hij si cumpl oblig	Drama
sissi habil sol asunt sin conflict aprovech cualqui invent sissi objet romp matrimoni hij amenaz grav enfermed sissi llev tras tiemp jov mejor enfermed	Romance
period limit ley vid punt parec ser problem convert pesadill	Comedia
existent chic maltrat padr humill gent puebl	Drama
madr consig puest trabaj pequeñ personal convencional har comienz demasi cambi dec investig extrañ cas client sospech enfermed	Drama
tres niñ tripul bord bell gat vagabund habit isla cab verd asi inici relat muj desconoc lee cart oper cam traves viaj recuerd sin cos hac corazon	Documental
director fam mundial lleg sol fam trabaj tras sufr decid pon fin carrer regres pequeñ puebl pas zon nort lleg pequeñ revolu pues convert objet habit puebl profesional pequeñ cad	Romance
años famili mism mantien conciert conoc salvaj prob pod hombr descubr siempr control anim accion ser march herman viej mism fri acerc perd noch dispuest siguient mezcl termin aventur lug	Drama
nuev york hombr desaparec dej polic intim amig encuentr pist cart prostitut llam fond va surg relacion amor mientr investig baj fond empiez aparec prostitut asesin entonc asalt sospech pued ser victim	Misterio
cuatr joven estudi dos chic dos chic desaparec britan dos seman tard aparec chic tan logr real unic recuerd libr encerr compañer junt doctor polic intent descubr pas sid amig	Crimen
dos joven gan vid call extrañ enfermed llam provoc sueñ profund cualqui part	Drama
dos amig prim acab lleg unid viv flor aventur popul pelicul cin independient años rod apen dias equip sol once person tres actor ocho filmaffinity	Comedia
paul brillant profesor cas relacion demasi buen paul enfermed mortal si recib pront corazon mor part christin encontr tranquil despues pas marc drog alcohol	Drama
unid orden control tip comun transport sufr devast part grup terror cerebr escond tras cuent detall devast plan cont john bruc polic viej escuel conoc dos cos acerc com amenaz terror hombr tip trabaj	Acción
hombr llam mism inici terror call nuev york har seri ciud agent john acced jug jueg llam dic ayud comienz carrer averigu intencion terror	Acción
max brillant matemat punt dar descubr import vid numer rig aparent primer encontr numer mientr acerc verd period unas brutal max firm pretend secret ocult tras max	Misterio
nuev medi sigl amist dos compañer colegi adolescent tan despiert padr chic cre mund llen fantas refugi viv rest mund bas hech real	Drama
dec plen gran estadounidens jov parej band unid desafi autor atrac banc histori dos famos atrac banc unid años dos personaj peligr respons numer muert agent ley embarg pelicul da	Crimen
bob lid form espos parej rob habil objet neces drog dur siempr	Drama
mortal sid liber poblacion city alic supervivient encuentr corazon devast ciud somet experiment alter ahor fuerz habil deb utiliz quier sobreviv nuev aventur junt supervivient deb escap cad vez peligr city necesit luch fuerz violent criatur cre ciud final enfrent mortal	Terror
jov dur ayud herman convert numer pes medi pront consig ver hech realid tan sueñ exit conviert vid pesadill lad matrimoni cad vez march peor deb sal nocturn mujer mafi combat tiemp capital dispon volv nuev pas tip	Drama
jov walt mat estudi negr john shaft viol libert acus abandon pais embarg despues esper dos años shaft acab regres unid millonari padr walt pag nuev walt qued libr dese ver shaft muert unic mism destin quier dos jack jimmy asi trafic drog esper veng shaft hab humill barri control	Acción
prepar eleg bod nuev dur cuatr dias conflict gener segu tradicion modern muj bod hij llev casi bord ataqu histori desarroll med van lleg ciud mund novi lleg trabaj conoc novi novi part acept pues enamor present television prepar bod contrat organiz profesional eleg inteligent jov clas medi	Comedia
tan adolescent recib especial hor asist bod herman mejor amig disfrut hor firm proposit hac centr drog rob vuelv libr med pas hor tan asist punt barri famili amist amor cambi	Drama
detectiv priv john shaft recib visit polic pid inform mafios llam despues mafios ayud detectiv rescat hij sid secuestr band rival shaft viej amig decid investig asunt mund encontr chic shaft acab averigu utiliz	Acción
va ver novi ambos decid huir madr chic relacion pon contact mafios elimin realid quier jov com amant asesin mar va acompañ recuerd	Crimen
expuls band desesper encontr trabaj diner ident profesor dar clas escuel priv alumn rock alumn prodigi pued ayud gan band pas problem	Comedia
georg plan suicid angel envi deten intent georg cos com salv vid herman graci hab conoc georg asi amig descubr vid deb disfrut	Drama
bas novel escritor mal moment une espos tal aparec vid extrañ personaj acus hab relat	Misterio
chic pequeñ puebl atrap alli oblig familiar tras suicidi padr deb hac carg herman dos herman madr pes vid trabaj famili relacion mantien muj cas lleg puebl jov llam cambi	Romance
primer guerr mundial capitan beb huy aleman embarc ven oblig peligr primer vist dos ser junt sobreviv cambi relacion	Aventura
will jov rebeld inteligent especial matemat descubr talent part oblig eleg segu vid siempr trabaj facil buen amig algun aprovech grand algun univers sol solitari profesor ayud decid	Drama
medi sigl negr europ tras diez años combat cruz regres tierr sant hombr llen dud camin encuentr muert entonc propon jug part esper obten grand vid muert existent dios	Fantasía
cinc años empiez nuev vid junt padr lleg aleman niñ pront adapt nuev vid padr	Drama
vid lleg final gran talent vid nuev york cambi gent llev diez años cas trabaj tiend animal obsesion trabaj consig encontr trabaj plant edifici encuentr pequeñ puert permit secret aspir permit acced cerebr john	Comedia
john shaft vuelt polic detectiv negr busqued asesin client	Acción
detectiv john shaft viaj franci destru red trafic person	Aventura
dos diferent unid veteran jov sold her guerr años obsesion proteg tierr libert fantasm pas hombr amig familiar part jov viv europ ultim diez años	Drama
protagon ali interpret orden gobiern period va unid rod documental deb mejor pais aprovech trabaj tan facil parec	Comedia
sur unid plen paul vigil carg verd conden esper john gigantesc negr acus asesin brutal dos herman nuev años tras personal ingenu escond don prodigi med histori paul aprend ocurr inclus	Fantasía
parej sam exit hij años acab traslad cas tranquil ciud max acab sal carcel tras pas años acus viol adolescent prision estudi ley lleg respons conden sam ahor va dedic cad minut existent hac pag error ejecut terribl venganz aterroriz famili convirt vid pesadill	Crimen
jov cantant esper result medic lee cart pued mor trat ocup tiemp esper result conoc jov sold punt part hac servici muert	Drama
band organiz form seis individu contrat dar golp anterior vari miembr conoc nombr objet atrac empres llev diamant suen polic alli atrac rest reun lug	Crimen
actor pas veran conviv mism cam relacion unas cien hor part ultim veran atac novi anni	Documental
guerr fri error sac envi destru president unid fond trat hac volv sofistic segur impid ataqu asi deb convenc soviet	Drama
nort bord lujos pis comienz fiest mientr gigantesc dirig haci nav gran intent evit fuerz miembr tripul gran van par rest mar tras espectacul qued dej grand buqu oscur	Aventura
bas hech real prostitut ejecut flor tras autor seis asesinat inclu polic mat propi violent ataqu mientr ejerc bord desesper suicidi conoc dia bar jov sid envi padr viv tia cur victim tragic llen rapid enamor encontr razon viv encontr trabaj sig ejerc client maltrat mat propi asi tragic caden asesinat histori asesin histori amor dos	Crimen
johnny conoc nombr deb terribl car prision pag rob complic dej tir asesin ademas mejor amig polic propon sal cambi nombr criminal johnny propi ademas blanc aspect ofrec cambi form baj ident nuev johnny acept aunqu parec hab sal bien logr recuerd pas	Crimen
ladron trabaj rob contrat sol abandon habit sin ademas comport maner absolut pes decid cas averigu razon comport terribl accident llev situacion limit oblig enfrent terror cuy pas	Crimen
ladron american lleg par ayud amig atrac banc lleg capital frances ofrec espos noch abrir puert habit hotel encuentr llam juli pasion ambos habit aun miembr band dia siguient banc tom inclu dia trabaj banc vez dentr tension va atrac pierd control situacion van polic edifici	Acción
londr seri histori maner dec este pelicul mir mir encontr amor tod part personaj cad maner prim viej estrell rock sol habl relacion aspect ingenu amor	Comedia
histori centr william propietari tiend libr popul barri estrell moment entra tiend william embarc complic cuent ayud amig destac compañer pis observ com buen william muj cualqui ser human	Romance
jack libr viv centr acab desencaden guerr personal fri cabez cad jueg	Drama
final sigl ciud convert neces man obra tres joven estudi rig catol hij ambici judi aleman decid abrir fabric ciud hac fortun lanz diner pod filmaffinity	Drama
estudi american period encuentr gran visit amig londr acud espectacul invit hac desaparec mientr esper practic recib visit fantasm period muert ven año pet ric atract hij conoc aristocrat britan realid famos asesin seri conoc asesin	Comedia
llev cas años llev pes negoci famili convert cas viv madr herman mar aparent jov espos primer obra conoc tierr filmaffinity	Drama
cientif distint investig misteri unas extrañ llam puert estrell acompañ equip puert transport planet	Acción
muj fabric armas secuestr hombr busc venganz muert hij escuel empiez joe padr desesper tras asesinat hij larg busc venganz mism secuestr wallac muj fabric victor wallac muj tramp contact unas norm segu situacion	Suspense
aristocrat sid abandon amant ejecut acab ser tras ser rival decid suicid parej encontr plan mejor venganz	Comedia
histori conflict jueg pod secret famili ric	Película de TV
segun captur rock años sesent	Comedia
tras secuestr madr dos fri profesional crim ven violenci	Acción
bas famos mism nombr agent contrat misteri conoc mat diner cazador pres tras cambi asesin tod europ mientr intent averigu tramp	Acción
tony maquin plan espos har final acus asesinat ayud inspector polic ayud resolv misteri crim	Crimen
jov director cin ningun vest muj poc oportun hac pelicul gran estudi embarg convert director famos tras reun grup personaj realiz pelicul baj excentr cuid	Comedia
años ciud sur alemani viv muchach cri famili profund padr madr fri pes llev años libr dur batall dese sal cas ir univers vez alli libert primer vez amor amist hac romp famili baj siempr segur proteg bas mism personaj histori filmaffinity	Drama
veg sam profesional apuest director import casin pertenec grup mafios mision control negoci diner va par man jef sig veg lug millonari polit lug pas trafic drog maton dia violent jef encarg cuid sam lleg veg intencion qued	Crimen
tras pas años carcel rob man armad puest libert buen comport sal prision vest mism form negr oscur puert esper herman vest ident maner ahor unic conoc peligr sant necesit gran diner herman pon man obra	Música
epoc aventur relat venganz consecuent traicion imped amor fuerz mal lanz parej terribl convert dia noch unid encontr ali person ayud	Aventura
nuev famili guerrer viv suburbi gran ciud situacion person raz blanc vid famili problem alcohol delincuent medi	Drama
conoc jul jim convirt dos amig dia enamor mism muj final cas obra capital cin frances sesent hermos amor pasion	Drama
año relat cambi mund grup estudi frances par veran poc intent principi romp burgues part comun nombr comun grup estudi frances empiez pregunt mund cambi aunqu consider terror posibl	Comedia
wallac perr disfrut dia	Animación
nuev aventur wallac mod acab sal car esper despues conoc cas aparent	Animación
famili martin siempr pasion corr ven cabez famili ve camin jov talent hij herman mayor ahor junt deb regres carrer mientr intent escap propi aprend dur pued lleg ser ser famili	Familia
acerc concurs puebl wallac dos amig hac invent form control intent preci pront enorm misteri empiez aterroriz atac noch organiz concurs absolut desesper encarg captur terribl criatur salv concurs victor decid mat tir convert hero local consegu cas ric hereder concurs jueg dej victor criatur verdader intencion cazador pued ten grav consecuent	Aventura
nuev entreg tras dia final john connor hombr destin resistent human ejercit futur connor cre ve alter part extrañ cuy ultim recuerd hab muert hab padr john connor deb decid si sid envi futur rescat pas carrer mientr resistent prep ataqu final corazon centr oper	Acción
alex jov sueñ lleg ser pod viv ademas pag clas bail dia trabaj noch bail nocturn	Drama
llen buen intencion hor hac amig enamor compañer trabaj sab desesper conquist vend cambi siet dese	Fantasía
agent años hac tiemp vid dia decid aprend bail	Romance
pequeñ cost nuev cre unic cuy existent mil años atras nombr escap muert tras mont segun tradicion jef ser niñ once años cre destin ser autor ello aunqu abuel enfrent mil años tradicion	Drama
jov tras comet rob march ciud conduc hor par pequeñ jov llam norm parec tranquil cas lad viv norm madr mientr jov asesin salvaj	Terror
histori grup agent secret atract jef grup criminal vuelt unid grup espi form chic sig pist agent import bell desaparec misteri tras enfrent car car delincuent comienz busc sospech quier ser rescat	Acción
jueg interpret frank tras pas buen carcel regres cas chicag junt muj firm proposit dej atras pas criminal result facil esper viej trat medi regres antigu habit	Drama
jov sacerdot sal conviert padr pequeñ puebl segu puest mantien relacion muj dud hac trat consegu diner padr intent huir comport superior pon prueb carrer sacerdot tras conoc muchach hermos ciud	Drama
londr frank detectiv ocup parec trabaj alic novi alic acept sal eleg artist educ maner invit visit lujos apartament	Drama
viv años vid razon desgraci famos chic des fin consig ten cit fiest desgraci accident plan ahor parec oportun	Romance
tranquil local dos joven viol salvaj niñ negr diez años mayor blanc ciud tan crim carl lee padr niñ armad asalt decid tom man mat hij mientr tension va call jov blanc har posibl salv vid carl lee proteg	Crimen
vid oper experiment gir averigu hombr hij adolescent dedic call nuev york	Drama
amig sal dar caball sufr terribl accident ser caball mientr result her intent desesper recuper accident convert caball salvaj madr decid ir ver tom especial habl cur caball	Aventura
sigl baj puert sacerdot tres band acus hab dad muert señor viol espos detall crim narr punt vist band muj señor ayud unic testig hech	Crimen
pas ser jov desconoc convert famos mundial comienz años andy artist epoc import priv mientr enfrent espectacul fam mund drog artist mur años	Drama
