sinopsis	genero
eddi convenc tres amig jug ahorr part cart harry hach mafios barri part amañ eddi sol pierd diner sin contra deud medi millon libr deb pag plaz seman mafios pretend qued local padr resarc deud cuatr amig plan sald form arriesg	Comedia
stan corrupt agent dea cuy codici llev comet asesinat call nuev york mortal jueg gat raton empiez cruz camin solitari hombr llam leon leon asesin sueld personaj indestruct indocument sol beb lech ocup plant medi encuentr huerfanit 12 años pued olvid hombr asesin famili	Crimen
cècil sonj richt joachim nikolaj lie kaas punt cas ven trunc futur sufr accident qued tetraplej embarg terribl cècil enamor mar respons accident padr famili tres hij	Drama
sobrellev insomni cronic sufr despues regres vietnam travis decid trabaj taxist nocturn individu contact gent observ violenci desol hund ciud nuev york travis anot diari tod impresion dia decid pas accion	Crimen
manni ladron poc mont acept particip gran golp vend diamant rob cien mil marc deb entreg mediod trafic pierd bols contien diner metr berlin ultim recurs llam novi lol veint años cabell roj fragil decid explic situacion once cuarent minut si veint minut manni recuper diner hombr muert desesper jov precipit haci capital veint minut encontr cien mil marc reun manni salv hombr vid	Acción
marty mcfly estudi secundari 17 años envi accidental treint años pas delor viaj tiemp invent gran amig excentr cientif doc brown	Aventura
com mercenari contrat cia rescat pilot apres guerrill selv centroamerican mision result satisfactori viaj regres dan cuent dandol caz result ser cazador alienigen qued calaver victim trofe	Ciencia ficción
franky ladron diamant entreg enorm piez jef avi camin tent boris apost combat ilegal boxe realid tramp atrac avi enter contrat tony encontr franky diamant pront descubr trist destin franky caz captur gem desaparec llev mund jueg loc corr riesg descontrol engañ chantaj fraud mezcl form sangrient perr diamant boxeador gran varied armas caotic meriend negr	Crimen
accident coch juli pierd espos patric prestigi compositor hij ambos anna recuper lesion juli decid comenz nuev vid independient solitari anonim alej privilegi disfrut proposit cruz sandrin period especializ music persig intent prob juli compon piez hic famos mar pretend entrar vid olivi ayud patric enamor juli años atras convenc termin « conciert europ » ambici obra inacab music	Drama
karol ama profund dominiqu problem impotent sexual sufr provoc divorci seri penuri suced vid karol ver oblig volv poloni natal intent gan vid pued	Comedia
valentin jov model comienz ser conoc atropell coch rit perr esper cachorr despues cur intent devolv dueñ asi conoc hombr mayor juez jubil rechaz animal valentin descubr obsesion enfermiz aficion espi mund	Drama
emigr cuban fri sanguinari tony montan lleg cub instal miami propon hac nombr dentr crim organiz flor junt amig manny river inici ascendent carrer delict	Acción
curs italian une seis danes problem sentimental comun andre jov sacerdot envi parroqui pequeñ barri copenhag reemplaz wredmann cur viv enfrent feligres pondr cos facil provisional aloj hotel conoc jorg tim conserj aprovech noch andre apunt curs nocturn italian alli conoc olympi ayud pastel amig kar peluquer ambient latin clas favorec presenci italian giuli empiez produc efect enred pasional suced	Comedia
dos monj viv monasteri aisl baj atent mir viej jov ve pas estacion vid primaver niñ monj rie ran intent libr piedr espald veran monj adolescent conoc amor otoñ monj treint años intent hac va naturalez inviern monj proxim vejez algui lleg monateri primaver viej monj convers naturalez cerc jueg niñ monj	Drama
acaudal fri hombr negoci conoc hollywood boulevard jov atract prostitut alquil seman acompañ cen client ello chic ver somet cambi look tras nadi podr ver simpl vist chic call	Comedia
not hombr fracas par dia confund person mism nombr dos maton irrump apartament destroz alfombr creyend jeff lebowski millonari pasaden prim error not visit opulent tocay esper repong viej alfombra.sin embarg reticent hero compinch wat ven atrap thrill toqu humorist estil herman coen mezcl extorsion traicion decepcion chantaj sex drog	Comedia
chris wilton ambici jov profesor tenis escas recurs econom graci amist tom hewett consig entrar alta socied londinens enamor herman chlo tom part sal nol ric atract american chris encaprich verl azar pasion ambicion llev chris comet accion determin vid demas siempr	Drama
jov agent tesor elliot ness lleg chicag determin deten capon va ser tare facil puest capon polic bolsill ness conoc jimmy malon guardi veteran probabl honr cuerp ness pid ayud cruz capon	Crimen
charli bucket freddi highmor niñ buen famili pobr gan concurs junt cuatr niñ diferent part mund disfrut visit dia gigantesc fabric chocolat dirig excentr willy wonk johnny depp equip oompa-loomp fabric parec mund fantast magic llen diferent sabor dulc	Aventura
documental dur vid esquimal viv region hudson canad filmaffinity	Documental
tierr medi señor oscur sauron cre grand anill pod forj herrer elfos tres rey elfos siet señor enan nuev hombr mortal secret sauron forj anill maestr anill unic contien pod esclaviz tod tierr medi ayud grup amig valient ali frod emprend peligr viaj mision destru anill unic señor oscur sauron cre anill envi servidor persegu grup si sauron logr recuper anill final tierr medi	Aventura
compañ anill disuelt portador anill frod fiel amig sam dirig haci mordor destru anill unic acab pod sauron mientr tras dur batall orcos cay borom hombr aragorn elfo legol enan gimli intent rescat median merry pipin secuestr ogros mordor part sauron traidor saruman continu plan mordor esper guerr raz libr tierr medi	Aventura
fuerz sarum sid destru fortalez siti lleg moment dec destin tierr medi primer vez tiemp parec pequeñ esper atencion señor oscur sauron centr ahor gondor ultim reduct hombr aragorn reclam tron ocup puest rey fuerz sauron prep lanz ultim definit ataqu rein gondor batall decid destin mientr frod sam continu camin haci mordor esper sauron repar dos pequeñ hobbits acerc cad dia final camin mont destin	Aventura
adapt dibuj anim extraordinari novel tolki centr primer mit trilog the fellowhip of the ring primer part the two towers tierr medi verd prader comarc frod bolson sobrin bilb bolson embarc larg peligr aventur evit anill magic pertenec tio caig ahor pod malv sauron dueñ mordor	Aventura
dram ambient poloni 1982 plen guerr fri general wojciech jaruzelski jef suprem part comun gobiern pais baj ley marcial ejerc especial represion ilegal sindicat obrer solidar cre astiller gdansk	Drama
harry pott regres quint año hogwarts aun sacud tragedi ocurr torne tres mag deb ministr magi nieg regres lord voldemort harry conviert centr atencion comun magic mientr luch problem colegi inclu nuev profesor dolor umbridg intent aprend misteri orden fenix	Aventura
raf danny crec junt zon rural estadounidens amist prolong larg años fil ejercit air dos pilot combat raf encontr evelyn valient enfermer amor vid pront llam serv fuerz aere britan combat nazis represent ejercit estadounidens mientr danny evelyn envi bas aere pearl harbor hawai vez alli ambos enamor mientr raf derrib combat sorpres ambos raf sobreviv regres pearl harbor complic produc mortal bombarde part ejercit japones	Acción
enfrent futur inciert witek jov polac estudi medicin decid interrump temporal estudi cog tren ir varsovi	Drama
tras sufr ataqu monstruos jabal maldit jov ashitak emprend camin busc cur deteng infeccion mientr human acab bosqu dios convert temibl besti hac posibl proteg encabez mononok princes guerrer ashikat deb escog band decid si ayud hombr deidad intent deten maldicion her extiend cuerp cuartel	Aventura
chihir niñ diez años mud padr nuev hog camin famili top enorm edifici roj cuy centr abre larg tunel lad pasadiz dibuj ciud fantasm restaur abandon ciud padr chihir encuentr gran varied plat delici decid qued com prob boc transform cerd pres panic chihir huy empiez desmaterializ enigmat haku explic funcion univers caid salv padr niñ enfrent terribl yub aspect arpi diabol	Animación
jul vincent dos asesin sueld poc luc trabaj marsellus wallac vincent confies jul marsellus ped cuid mia muj jul recomiend prudenci peligr sobrepas novi jef lleg hor trabaj ambos deb pon man obra mision recuper misteri maletin	Suspense
tras pas unas merec vacacion franci agent secret jam bond recib llam jef m realiz peligr mision relacion diamant brut desaparec	Aventura
detall cronic famos gir grup rock britan the rolling ston realiz unid 1969 culmin desastr tragic conciert celebr 6 diciembr altamont speedway fre festival event trascendent histor pues marc final gener paz amor convirt golp gener desengañ	Documental
dram belic bas histori real regimient escoces captur japones ii guerr mundial 1939-1945 vio oblig constru tristement famos via ferroviari muert	Drama
siempr interes ofrec herman coen firm divert inclasific comedi eficac gir dramat narr histori tres reclus tras escap carcel sureñ decid plen fug gan diner grab cancion exit destac simpat clooney demuestr talent comedi llev glob oro mejor music band sonor pelicul alcanz gran	Aventura
aclam documental film d.a pennebak cubr principal gir britan ofrec bob dylan primaver 1965 trobador folk american nombr real robert allen zimmerm cont sol 23 años gir dylan apen 3 seman document detall cam sig alli va aeropuert hotel mostr convers conciert ademas cont aparicion artist joan baez donov alan pric documental tiemp agrand import influenci filmaffinity	Documental
circ llen ser deform tull person divers amput hans enan hered fortun part moment cleopatr bell contorsion intent seduc hac diner logr objet traz plan cont complic hercul forzud circ	Drama
phil hombr tiemp caden television envi año punxstawnwey cubr inform festival dia marmot viaj regres phil equip ven sorprend torment oblig regres pequeñ ciud mañan siguient levant phil escuch radiodespert mism program mañan anterior	Romance
cond dracul abandon carpat trasl londr llev sirvient contabl vez instal enamor jov promet empiez visit noch va beb sangr convert asi espos malest sufr jov alert famili busc ayud doctor van helsing	Terror
krest viv copenhag integr circul yuppi ciud brillant futur noch bod suen telefon llam lejan inform muert padr krest ve oblig explic situacion mund cre inclu espos ningun parient cercan krest regres arruin granj padr viv herman mayor hombr aspect desaliñ solitari facultad mental merm impid val mism avergonz ver com irremedi va sal luz pas pueblerin trat manten alej muj invent mentir tras	Drama
pelicul pedr almodov explor abus sexual iglesi catol español dec 1960 pelicul trat dos niñ maltrat escuel catol luch enfrent tard ident sexual odi haci sacerdot	Drama
donni chic american dot gran inteligent imagin tras escap milagr muert casi segur comienz sufr alucin llev actu nunc imagin descubr mund insolit alrededor pues vision gran conejit manipul comet seri crimen	Fantasía
veran 1963 dos vaquer ennis mar jack twist conoc mientr hac col ser contrat rancher joe aguirr dos aspir consegu trabaj establ cas form famili aguirr envi cuid gan majestu montañ brokeback ambos surg sentimient camarad deriv haci relacion intim conclu veran abandon brokeback segu camin diferent	Drama
mitic pelicul antibel plasm sentimient sensacion desilusion grup joven estudi envi frent primer guerr mundial 1914-1918 adapt novel homonim escritor aleman erich mar remarqu estren provoc enfrent nazis comun	Drama
dos angel sobrevuel berlin ciud divid mur vergüenz sol visibl niñ hombr corazon pur testig impotent pued cambi curs acontec sient gran compasion ser human decid conoc sentimient mortal enamor jov trapec	Drama
principi años 70 bess watson ingenu jov puebl coster escoci enamor jan stell skarsgård hombr mundan trabaj plataform petrolifer pes oposicion rig comun puritan pertenec bess jan cas tras bod vuelv trabaj cuent dias esper vuelt bess creyent devot cre amor bendec ciel dia suced terribl accident primer pelicul trilog corazon dor lars von tri	Drama
chin año 43 1779 ambient histori dinast quing li mu bai virtuos artes marcial pod espad magic conoc destin verd este quier segu siend guerrer decid darl espad mejor amig sir lleg moment entreg conf enamor guerrer yu shu lien encarg llev ciud pekin encuentr compañer embarg noch enmascar entra cas sir rob espad asi mu bai shu lien lanz busqued destin verd despert ello viej fantasm pas	Aventura
doc años antoin doinel ve oblig sol conviv problem conyugal padr atrev afront sin soport exigent sever profesor dia asust cumpl castig maestr impuest decid hac novill amig ren inesper ve madr compañ hombr culp mied arrastr seri mentir riñ van cal anim des dej atras problem sueñ conoc mar traz ren plan escap	Drama
conmovedor histori chic sordomud envi plataform petrolifer cuid hombr qued cieg terribl accident chic habil especial conect hombr bord	Romance
corr año 2019 policial polit trampos sect religi revolucionari proyect cientif secret combin caus atmosfer explos neo-toky grup rival quier control akir chic extrañ poder psiquic sid manten baj custodi criogen 30 años medi tens atmosfer jov psiquic llam tetsu liber akir	Animación
par asesin escrupul consig huir prision dej tras horribl reguer crimen malhumor detectiv jack cat qued opcion sac timador reggi hammond penitenci ayud encontr criminal embarg sol dispondran 48 hor hammond deb regres carcel	Suspense
canfield mckay hered enemist pas padr hij much gener caprich destin willi mckay bust keaton cog tren nuev york conoc virgini canfield natali talmadg	Comedia
sigl xxiii almir jam kirk nav enterpris encomiend dificil mision neutraliz extrañ cuerp colision tierr oficial spock capitan willard deck asesor ili doctor mccoy ayud almir kirk descubr naturalez cuerp sideral provist mecan inteligent orig terrestr expedicion enterpris localiz ente entonc aprest introduc centr oper	Ciencia ficción
bob harris charlott dos norteamerican encuentr toki bob estrell cin median edad ven rod anunci charlott muj jov acompañ tod part mar fanat trabaj incapac dorm camin bob charlott cruz casual tard nac sorprendent amist aventur junt vid nocturn toki compart inolvid experient habit ciud termin descubr nuev maner ver vid	Drama
enterpris transport grup cientif dispon pon prueb mayor experiment jamas imagin hombr formacion vid planet inert	Acción
batman/bruc wayn regres continu guerr crim ayud tenient jim gordon fiscal distrit harvey dent batm propon destru crim organiz ciud gotham triunvirat demuestr eficaci repent aparec jok nuev criminal desencaden caos aterr ciudadan	Drama
extrañ comedi acerc dos herman wilbur quier suicid harbour trat evit padr muer dej libr conoc muj har vid mejor tra nuev problem	Comedia
tras desaparicion spock creacion planet genesis tripul enterpris dispon localiz cuerp compañer peticion padr este	Ciencia ficción
dos joven enferm terminal dedic viv intens aloc ultim dias salt tod norm histori narr combin mod singul dram comedi present situacion dispar provoc ris aunqu anhel intim protagon revel limit mar aleman thom jahn logr impregn entid dramat atrev pelicul gan premi mejor pelicul festival sitg 1997	Comedia
expuls noch apartament compart novi dor tras ser sorprend esta compañ muj atract alex qued call alli conoc walt homosexual atraid llev fiest gay present norbert propietari gran apartament import compart pues atraid alex	Comedia
l'arrive d'un train à ciotat dud film famos histori imag tren lleg estacion pas cerc cam mientr reduc veloc convirt rapid escen absolut icon curi recient invencion llam cinematograf	Documental
danny oce carismat ladron tan sol 24 hor despues cumpl larg conden prision plan proxim delit objet realiz mayor atrac casin histori ello form equip once hombr cad mejor camp embarg surg problem inesper dueñ local terry benedic sal tess ex-muj	Suspense
eras vez castill viv inventor dedic part vid cre criatur perfect llam edward inventor mur repent dej incomplet creacion vez ded unas horribl man hoj tijer pobr edward viv sol castill encant jov trabaj firm avon llev cas junt famili criatur tan especial edward prepar viv ciud tan extravag fals suburbi	Fantasía
pas tres años danny oce georg clooney equip –lider detall rusty ryan brad pitt prometedor carter linus caldwell matt damon expert explos bash tarr don cheadl desvalij caj fuert frank catton berni mac – llev cab audac lucrat atrac histori rob despiad empresari terry benedict andy garci ultim centav guard impenetr cam acoraz veg despues repart 160 millon dolar consegu cad conoc miembr equip oce trat port bien pas desapercib llev vid legal result ser dificil disgust tess juli roberts espos danny	Suspense
holly golightly bell jov alta socied neoyorquin baj vid alegr escond gran tristez holly comport aloc algun man ejempl desayun contempl escaparat lujos joy tiffanys dia mud mism edifici paul varjak escritor ciern mientr esper alcanz exit nunc lleg viv relacion muj madur mantien holly paul ensegu entabl bonit amist	Comedia
marty doc vuelv hac aloc secuel exit taquill 1985 duo viajer tiemp dirig 2015 cort raiz problem famili mcfly cos sal mal graci maton biff tann molest almanaqu deport ultim intent aclar cos marty encuentr destin 1955 car car padr adolescent nuev	Aventura
vic 13 años nuev institut pront hac amig penelop dos ansi encontr chic enamor problem padr vic dej todav ir fiest filmaffinity	Drama
emocional powell siend desafi pacient pabellon psiquiatr prot reclam ser planet anunci part tierr rest pacient apunt ir situacion dej powell pregunt acerc propi habil distingu realid fantas	Ciencia ficción
sigl xxiii misteri pod alienigen amenaz tierr evapor ocean destru atmosfer frenet intent salv human capitan kirk tripul viaj tiemp regres san francisc 1986 encontr mund punks pizz autobus cambi exact result tan alienigen encontr lugar recondit galaxi	Ciencia ficción
grup polic angel enfrent misteri asesin descuartiz victim salvaj inusit pront jef grup capitan harrig descubr enemig alienigen lleg tierr unic proposit practic caz	Ciencia ficción
londr cementeri call ahor desiert rein silenci total tras propag virus acab mayor part poblacion lug invasion ser terrorif virus difund tras incursion laboratori grup defensor derech animal transmit sangr virus produc efect devast 28 dias epidemi extiend pais sol qued puñ supervivient	Terror
adapt comic frank mill autor comic city famos batall termopil 480 objet jerj emper persi conquist greci desencaden guerr medic dad graved situacion rey leon espart gerard butl 300 espartan enfrent ejercit pers inmens superior	Acción
nav enterpris dirig planet nimbus iii negoci liber embaj secuestr alli descubr jef band parient spock obsesion encontr planet consider fuent vid	Ciencia ficción
adapt novel homonim juli vern 1870 deb relat mariner asegur hab vist monstru marin sur pacif unid flet buqu guerr destru besti alter tranquil mar monstru atac sirv poderi belic evit desastr tras hundimient buqu tripul rescat propi monstru result ser buqu capaz sumerg mar inedit entonc	Aventura
tras años guerr feder imperi klingon dispon celebr conferent paz panoram negoci intergalact implac enemig preocup almir kirk nav klingon atac responsabiliz enterpris ambos mund prep pued ser encuentr definit	Ciencia ficción
jacqu mayol jov frances talent especial buce ayud profesor lawrenc experiment marin niñ viv pequeñ poblacion grieg junt gran amig enzo molinari ahor campeon buce apne jacqu perd padr trabaj buz pes ello ama mar encim consig vid llen baj agu	Aventura
hombr llam adam despiert encaden tub oxid dentr decrepit cam subterrane lad encuentr person encaden lawrenc gordon hombr muert revolv calibr 38 man ningun dos sab alli sol pos casett instruccion dic gordon deb mat adam ocho hor si fall ambos mor junt espos hij record investig asesinat llev cab detectiv llam tapp gordon descubr adam siend victim psicopat conoc jigsaw sol qued unas hor desenred complic rompecabez inmers asesin dej unic unas pist dos sierr man demasi debil cort caden ata suficient fuert cort carn hues	Terror
imponent nuev york jack jeff bridg locutor radi caid desgraci parry robin williams enajen profesor histori emprend busqued sant grial	Comedia
boston sufr conmocion explosion tal feroc dej alient inclus miembr dur brig antiexpl ciud tod prueb apunt terror temibl habil enfrent nunc enigm except jef unid jimmy dov enfrent adversari mortal dov consider part pas enterr inici persecu tan personal desesper	Acción
silvi broom nac afric interpret nacion unid oye com amenaz muert president african acus genocidi pais dias dar discurs asamble general tobin kell agent federal encarg proteg comienz levant sospech ideal motiv	Crimen
washington dc año 2054 polic utiliz tecnolog psiquic arrest enjuici asesin comet crim futur pued predec culpabl deten unid elit precrim pued delinqu prueb bas precogs tres ser psiquic cuy vision asesinat nunc fall	Acción
bean trabaj vigil prestigi royal national gallery jef hart quier desped caus continu metedur pat pued hac cuent recomend director muse asegur incompetent qued manifiest ingeni plan envi ee.uu expert arte fin adquir cuadr valios mund	Comedia
1945 termin segund guerr mundial jak geism georg clooney corresponsal guerr norteamerican vuelv berlin inform conferent postdam reun trum churchill stalin mism tiemp ve envuelt turbulent asunt intent ayud len brandt cat blanchett antigu amant cuy mar busc american rus	Drama
jimmy niñ dificultad comun logr escap centr intern ayud medi herman corey viaj haci californi unen haley niñ mism situacion decid acud concurs videojueg celebr angel descubr jimmy expert	Aventura
jacki brown pam gri azafat vuel necesit diner hac corre robbi mafios busc polic parec ir bien dia sorprend aduan acus trafic drog evasion capital sol podr evit ingres prision si acept propuest polic ayud lleg robbi	Crimen
gran bretañ futur indetermin alex jov agres dos pasion violenci desafor beethov jef band drug dan riend suelt instint salvaj apal viol aterroriz poblacion escal terror lleg asesinat alex deten prision somet voluntari innov experient reeduc pretend anul drastic cualqui atisb conduct antisocial	Ciencia ficción
slevin vid ido bien cas acab ser declar ruin sorprend novi cam intent perd vist angel tiemp march viv nuev york apartament amig nick fish dos peor gangster ciud rabin jef antigu soci ahor enemig irreconcili cruz vid pretend veng muert hij asesin primogenit ide desencaden guerr band busc jugador deb diner jef oblig mat hij rabin	Drama
bienven city ciud polic corrupt atract dam vigil desesper busc venganz redencion ambas cos univers her inverosimil intent hac correct city ciud viv luz oscur llen personaj singular ejempl marv mickey rourk supervivient busc veng muert unic amor dwight cliv owen investig priv intent dej problem atras despues polic asesin dwight par proteg amig final histori hartig bruc willis ultim polic honest city va tras pist jov man sadic hij senador result inesper	Suspense
shanghai 1942 ciud ocup japones señor mak muj ric sofistic recuerd com empez 1938 verdader nombr mak sin wong chi chi estall ii guerr mundial 1939-1945 padr huy inglaterr dej chin estudi universitari conoc kuang yu min acab fund compañ teatr foment patriot wong chi chi convirt primer actriz compañ kuang part convenc grup estudi asesin señor yee import colabor japones wong chi chi colabor plan hac pas señor mak comet hac amig muj yee gan confianz este seduc iba suced segun previst produj acontec inesper	Acción
sord call city hombr busc venganz dwight trat ajust cuent misteri ava lord letal muj traicion nancy intent super muert hartig johny peligr mision acab mayor villan city proposit conoc jov stripp marcy	Crimen
detectiv georg montgomery busc valiosisim moned sid rob coleccion acaudal muj pesquis involucr encuentr muert man organiz delict ansi hall preci moned	Crimen
clar hans dos terror izquierd huy polic hac quinc años hij jeann adolescent cad vez rebeld enamor muchach desconoc conviert amenaz segur padr	Drama
sigl xiv comienz hermos mañan final noviembr 1327 monj franciscan antigu inquisidor acompañ novici discipul –qui relat historia– acud abad benedictin situ nort itali intent resolv crim estanci van desaparec misteri religi despues hall muert graci inform aport monj guillerm va esclarec hech movil crimen parec ser antigu trat custodi bibliotec complej dic mayor mund cristian ¿quien asesin ¿qu motiv muert victim nadi sabe…	Drama
jam kirk montgomery scott pavel chekov asist viaj inaugural uss enterprise-b requer ayud convoy nav hall atrap cinturon energ deb inexperient capitan kirk decid ayud cubiert hall destru rafag energ dad muert	Ciencia ficción
ameli chic demas vist pez color desliz haci alcantarill municipal madr mor plaz notre-dam padr dedic afect gnom jardin repent veintidos años descubr objet vid arregl vid demas part entonc invent tod clas estrategi interven den cuent existent vari person entorn porter pas dias beb vin oport georgett estanquer hipocondriac hombr cristal vecin sol ve mund traves reproduccion cuadr ren	Comedia
lily miriam hopkins carter hac pas condes conoc veneci famos ladron gaston monescu herbert marshall vez hac pas baron enamor gaston rob aristocrat françois fileb huy lily descubr casi año despues par gaston rob bols diamant incrust viud mariett colet devuelv cautiv tal form contrat secretari	Comedia
atrap 1955 marty mcfly enter muert doc brown 1885 deb viaj tiemp salv combust delor dos deb averigu com escap viej oest emmett asesin	Aventura
¿qu clas hombr desafi rey histori epic medieval independent escoci sigl xiii bas leyend william wallac montañes escoces arrastr clan luch tiran rey eduard i inglaterr despues brutal asesinat jov espos ingles wallac sol busc venganz hambrient inferior numer wallac lider patriot escoces consig organiz ejercit guerrer sedient libert logr recuper ello espiritu har escoci libr siempr	Acción
trop hitl invad varsovi ciud compañ teatr iba represent obra ve oblig sustitu hamlet mientr espos actor principal empiez flirt apuest oficial	Comedia
capitan enterpris encuentr nuev adversari borg intent imped modific histori conquist tierr sigl xxi medi viaj tiemp imped prim vuel warp raz human consiguient prim contact raz extraterrestr vulcan	Ciencia ficción
jean-luc picard capitan uss enterpris recib mensaj flot parec comand dat encontr estudi socied primit sufr cortocircuit revel existent equip investig habit planet ba'ku pront descubr intent defend esta socied inocent aspir	Ciencia ficción
polic romulan obtien adn capitan picard fabric clon llam shinzon final introduc feder plan qued envi clon min diliti rem planet herman romul capital imperi romulan shinzon organiz golp graci fuerz reman imbat nav erig nuev pretor romulan	Ciencia ficción
futur lejan gran bretañ pais totalitari dirig man hierr tiran john hurt tard tras toqu qued nocturn jov evey natali portm rescat plen call misteri enmascar cuy nombr v hug weaving extrañ personaj explic cual plan combat falt libert part moment accion v objet hac estall pais revolu gobiern fascist	Acción
nuev york 1972 charli harvey keitel jov italoamerican 27 años trat ascend mafi nuev york dich ascens ve obstaculiz sentimient respons haci imprudent amig johnny boy robert nir	Drama
tension cuatr trabaj compañ petrolifer estall peligr viaj transport nitroglicerin	Drama
1994 guerr civil ruand odi ancestral hutu etni domin tutsi provoc asesinat president pais disturbi call final terribl matanz dos etni paul hutu trabaj gerent hotel kigali empiez disturbi decid mejor refugi precis hotel haci alli organiz huid desesper acompañ sol famili sin vecin tutsi bas hech real	Drama
pintor paul gauguin llev vid acomod agent bols par decid abandon dedic pint 1891 instal tahiti vuelt par exposicion 1897 result fracas paul gauguin vuelv mar sur acab obra	Drama
elit estrict colegi priv nuev inglaterr grup alumn descubr poes signific carp diem import persegu sueñ graci excentr profesor despiert ment medi metod convencional	Drama
miss marpl pertenec consej administr buqu escuel miembr sid asesin inspector llev investig conclu muert deb fall cardiac miss marpl cre sid envenen tras examin caj rap muert cuart ultim pelicul margaret rutherford papel miss marpl	Drama
lorelei dorothy dos cantant hac crucer unid par rubi moren bellez encant seduc pasaj dos mism objet cas millonari inconvenient lorelei novi cuy padr contrat detectiv sigu	Música
rabin nuev york ver envuelt tremend lio terror arab neurot personaj	Comedia
prision brandenburg año 2000 martin schultz 36 años edad puest libert tras 11 años carcel calid ciudadan anterior republ democrat aleman berlin viv caid mur berlin celd prision ser liber entreg objet llev moment detencion carnet ident rda color azul permis conduc rda carter diner rda filmaffinity	Comedia
critic teatral acab cas decid visit ancian tias march lun miel visit descubr encant viejecit maner peculi practic carid	Comedia
deb malentend rog thornhill ejecut mund public espi confund agent gobiern llam georg kapl secuestr tres individu llev mansion interrog consig huir mat dia siguient regres cas acompañ polic rastr person descrit	Misterio
nuev macabr aventur siniestr jigsaw hombr muev hil espant jueg aterroriz comun desconcert polic jigsaw vez consegu escap vez ayud nuev aprendiz amand shawne smith mientr polic local intent localiz doctor lynn denlon bah soomekh jeff angus macfayd sab punt convert siguient peon horribl jueg	Terror
decid rap muer despaci aparec nuev victim asesinat sign caracterist jigsaw agent eric matthews donni wahlberg embarc investig exhaust permit deten asesin demasi esfuerz embarg jigsaw ser deten sin part retorc plan ocho victim jug vid ahor toc matthews unirs jueg	Terror
caf acud trabaj inmigr emmi kurowski viud sesent años conoc salem marroqu treintañer induc dueñ bar salem invit emmi bail habl acompañ cas dia siguient qued viv relacion provoc gran escandal vecin visit propietari edifici denunci emmi	Romance
guerr fri 1957 indian jon harrison ford amig mac ray winston acab escap garr agent soviet remot aeropuert decan univers jim broadbent confies amig profesor jon ultim mision indy fracas punt ser desped mientr indian conoc mutt shi labeouf jov rebeld propon trat si ayud resolv problem personal cambi facilit descubr espectacular histori calaver cristal akator encuentr lug remot peru agent soviet dirig fri bell irin spalk cat blanchett mism objet	Aventura
cyborg sid envi futur mision mortal elimin sarah connor jov cuy vid gran import prox años sarah sol protector —kyle reese— envi futur terminator utiliz inteligent excepcional fuerz encontr sarah ¿hay algun form deten cyborg aparent indestruct	Acción
fantasm abuel iren carm maur aparec hij raimund penelop cruz sol lol dueñ niet paul yohan cob tia hij chus lampreav inclus vecin blanc portill pueblecit manch viv abuel vuelt atar cab qued suelt vid	Comedia
granjer californian dos hij cal aron caracter diferent ambos compit cariñ padr situacion cal complic averigu realid madr sol muert sin ademas regent local altern	Drama
tres joven jim stark judy platon coincid comis cad alli motiv distint jim borrach judy escap cas platon acab mat tir cachorr inspector ray descubr tres mantien relacion conflict famili jim judy van recog padr platon hij parej divorci conform visit cri negr viv	Drama
inspir documental soviet kino-nedeli 1918 dzig vertov ruttmann realiz 1927 cont mejor fotograf aleman epoc documental bas vid dia ciud berlin	Documental
tiemp perd espos rebec aristocrat ingles maxim wint conoc montec jov humild dam compañ señor american wint jov cas van viv mansion ingles manderley resident habitual wint pront señor wint da cuent pued borr mar recuerd difunt espos	Misterio
1976 jov cracovi realiz diplomatur cin investig vid obrer llam birkut 50 maner fugaz hero proletari objet investig origin leyend efect provoc	Drama
narr jorn revolucionari astiller naval gdansk danzig protagoniz obrer sindicat solidar veran 1980 mism año period radiofon amig regim comun verd deb cumpl mision difam destac milit sindicat solidar result ser hij hero hombr marmol 1977	Drama
teen brandon siempr des ser chic asi dia decid cort pel ocult pech baj vendaj apret cambi orden nombr pas llam brandon teen filmaffinity	Crimen
dos band adolescent rival todav van colegi asid futur esper joven margin desplaz outsiders acical gomin casi busqued siti socied ven reflej camin rect conllev facil tentacion violenci apen mes propi coppol estren histori pandill juvenil ley call rumbl fish 1983 hipnot relat convencional format inclu inclus toqu onir	Crimen
adapt cinematograf novel profesor unrath heinrich mann narr tragedi sever profesor noch va angel azul cabaret mal fam llev alli alumn acud local seduc encant cantant lola-lol dietrich embarg profesor rath solteron 50 años acab cayend red cabareter part entonc vid descens infi humill degrad moral	Drama
despues huid monstru cre doctor frankenstein siniestr praetorius propon cientif creacion compañer monstru	Drama
guerr cien años sigl xiv xv 1431 juan arco despues hab conduc trop frances victori arrest acus bruj decl hab recib dios mision salv franci proces conden mor hoguer	Drama
bas histori real robert baer georg clooney agent cia pas tod vid trabaj agenci orient medi investig cas terror experient beirut turbulent años ochent envi alli realiz complej mision implic dos empres petrolifer american punt fusion investig agenci federal estadounidens anal matt damon sector energ sed suiz	Drama
rusty jam matt dillon jov sueñ volv tiemp pandill juvenil emul herman mayor mickey rourk dia lid arrastr reput rebeld intoc chic mot ahor herman pues hac dos mes march rusty cit pele	Acción
nuev york 1963 radi suen the four seasons smok robinson the shirell ben king cos facil bronx chic form band callejer wanderers integr chic orig italian diferent band rival vec raz irreconcili violenci camin direct resolv	Drama
sent banc parqu francis anim compañer alan vay holstenwall ciud nort alemani ver espectacul ambul doctor caligari emple municipal nieg doctor permis actu aparec asesin dia siguient francis alan acud ver doctor caligari cesar ayud sonambul anunci alan porven viv amanec	Drama
pequeñ puebl oregon cuatr joven amig sal ciud busc chic desaparec sentimental geordi rud chris extravag teddy miedos vern des ser vist her mism ojos puebl emprend inolvid excursion dos dias conviert aventur increibl fum escond cuent histori suelt tac gust hac caus comun cos pon dificil encuentr maton puebl armad cuchill busc cuerp chic descubr fuerz nunc sup	Crimen
muriel chic sobrepes viv mund fantas cancion abba catalog nupcial sueñ princip azul algun dia liber odios famili burlon amig cans esper lleg decid irse ciud busc mayor exit cin australian novent	Comedia
glasgow principi años 50 joe jov encuentr trabaj barcaz propied enigmat muj tard joe encuentr cuerp muj flot agu aunqu polic arrest sospech hac cad vez evident joe sab muj ahog dic investig asesinat telon fond joe embarc aventur intim pasional	Drama
don vit corleon conoc dentr circul hamp padrin patriarc cinc famili ejerc mand cos nostr nuev york años cuarent don corleon cuatr hij chic conni tres varon sonny michael fred padrin reclin interven negoci estupefacient empiez cruent luch violent episodi distint famili crim organiz	Drama
epoc ley sec 1920-1933 joe jerry dos music monton ven oblig huir despues ser testig ajust cuent dos band rival encuentr trabaj mafi persig decid vest mujer toc orquest femenin joe conquist sug kan cantant grup fing ser magnat impotent mientr jerry cortej millonari quier cas	Comedia
continu sag corleon dos histori paralel eleccion michael corleon jef negoci familiar origen patriarc fallec don vit primer sicili lueg unid empez abaj lleg ser poderosisim jef mafi nuev york	Drama
micky mallory convencional parej joven amant sient nac mat dos despiad criminal atemoriz poblacion present program sensacional aprovech fascin personal ejerc public conviert asesin her televis	Crimen
michael corleon hereder imperi don vit corleon intent rehabilit social legitim tod posesion famili negoci vatican despues luch tod vid encuentr cans centr tod esper encontr sucesor hag carg negoci vincent hij ilegitim herman sonny parec ser eleg	Crimen
comedi romant mordaz rob gordon dueñ tiend disc chicag cuy peculiar vend disc vinil rob dic ser verdader fanat music pas tiemp championship vinyl dos emple dick barry dos tip peculi aunqu tres conoc fond mund music popul encant conciert ide hac list cinc mejor cancion tiemp categor especif rob pas mal moment relacion laur actual novi romp part moment rob empiez reflexion desengañ amor llam cinc principal dec chic dej huell vid dej lad music autent pasion vid junt mujer	Drama
equip cin va rod pelicul misteri isla teschi sumatr alli descubr existent civiliz prehistor tribu ancestral secuestr atract ann actriz protagon ofrec sacrifici ritual king gigantesc goril	Aventura
will lightm hugh grant solter 38 años viv derech autor cancion compuest hac años padr mied compromis tal sol relacion madr solter piens facil romp embarg conviccion tambal conviert mejor amig marcus niñ 12 años conoc cit	Drama
japon sigl xix zatoichi vagabund cieg viv jueg dar masaj ademas maestr espad rap precis mejor samurai ciud montañ merc band ginz zatoichi fiel amig shinkichi conoc par geish bell peligr okinu herman osei lleg ciud veng asesinat padr unic pist misteri nombr kuchinaw	Aventura
despues pas carcel johnny clay decid dar ultim golp vid permit retir junt amad fay plan llev recaud carrer caball hipodrom despues meticul seleccion colabor plane estrategi asalt precision insospech trat provoc alterc sal apuest mat caball favorit septim carrer clay cuent ayud randy polic soborn georg cajer apuest mik barm hipodrom atrac desarroll segun previst problem present repart botin	Crimen
epoc ley sec 1920-1933 dav contraband alcohol punt cerr trat import mafios chicag manzan mendig anni siempr dad suert envi hombr busc cerr oper anni complet desesper hij ve hac años lleg europ acompañ novi suegr aristocrat italian anni convert gran dam defraud	Comedia
desintegr matrimoni perfect tan model result insult vid tan comod vac produc espos madr ama cas perfect eficaz orond sirvient aleman complet cuadr famili cae cuent dese recobr propi ident	Comedia
arvid apac emple banc acab dej novi aburr colm hab deten ladron intent atrac banc trabaj sol acarre golp amenaz muj ladron acud cas increp supuest buen accion ahor van pod form famili arvid decid plan atrac darl diner parej ello recurr unic malhechor conoc herman harald trabaj cociner cont ayud tres emple pet martin vuk embarg sal previst final ajust cuent filmaffinity	Acción
parej enamor ve trunc felic asesin ladron neces salv vid chic hac permanezc tierr form fantasm intent advert peligr corr unic medi comun aloc vident	Fantasía
willy wonk excentr dueñ gran fabric chocolat dia decid ofrec cinc niñ entrad dor permit recorr dulc fabric ganador charli bucket niñ pobr buen corazon esper futur mejor madr cuatr abuel ganador result ser cuatr insoport niñ	Familia
tan sol veinticuatr hor tres agent servici secret britan investig red trafic drog aparec asesin extrañ circunst tod pist conduc big diplomat llam katang agent 007 jam bond envi nuev york investig enigmat personaj	Aventura
suert ann darrow cambi conoc carl denham empresari luch abrirs camin mund espectacul une jack driscoll autor teatr neoyorquin tres emprend viaj llev remot isla denham previst dirig pelicul alli descubr ser increibl goril gigant king kong habit frondos selv criatur prehistor viv ocult millon años denham apetit insaci grandez ensegu ve fam pued report captur goril exhibicion nuev york	Aventura
continu cicl antoin doinel tras cuatrocient golp l'amour à vingt ans protagon jean-pierr leaud tras ser expuls ejercit insubordin visit antigu novi christin darbon claud jad padr christin encuentr trabaj temporal antoin vigil nocturn hotel embarg culp detectiv priv pierd emple prim dia compens detectiv ofrec trabaj agenci principi antoin encarg asunt menor encomiend mision averigu tod emple zapat señor georg tabard michel lonsdal odi zapat antoin conoc fabienn tabard delphin seyrig espos propietari	Comedia
segund pelicul realiz torn personaj antoin doinel sig tras 400 golp realiz truffaut	Comedia
niñ orfanat pas tant hambr desesper decid habl asunt director eleg oliv twist expuls centr ofrec aprendiz quier contrat despues limpi chimen trabaj ayud enterr oliv escap lleg londr afuer ciud cans hambrient conoc artful dodg ofrec aloj entonc ver oblig trabaj malv fagin dirig band chic carter	Crimen
antoin christin parej recien cas mientr gan vid vend flor sec call par muj impart clas violin pas tiemp beb antoin sig siend hombr emocional inest inmadur aventur extramatrimonial	Comedia
tras cinc años matrimoni hij antoin doinel christin divorci trabaj corrector imprent enamor sabin vendedor tiend disc dia encuentr alli colett tazzi jov juventud musical conoc antoin colett prim amor antoin encuentr conoc monsieur luci ex-am madr tod mujer pas vid	Comedia
richard hannay music-hall londinens repent suen dispar comienz pele medi tumult chic asust pregunt si pued ir richard acced llev apartament	Misterio
inminent muert ancian patriarc acomod famili sur desencaden terribl tension hereder hij brick indecis apat refugi alcohol muestr complet indiferent situacion maggi muj dispuest contempl impas destruccion goop igual espos ambici oportun	Drama
amarg comedi narr histori rupert pupkin comic obsesion convert mejor camp dia rupert conoc idol jerry langford suplic oportun aparec show este nieg embarg cej empeñ acech jerry consig quier final ayud amig mash secuestr langford pod consegu proposit	Drama
vuel 209 trans americ sal angel destin chicag pasaj encuentr seri curios personaj ex-pilot combat plen vuel ver oblig hac mand avion comercial tras qued pilot indispuest com mal	Comedia
dos mochiler norteamerican dav kessl jack viaj europ camin zon rural inglaterr poblacion local mir mal entran bar sal recib tip extrañ advertent carreter alejens pantan lun aun asi joven adentr oscur dan cuent siend segu terribl criatur	Terror
lili marl histori cancion segund guerr mundial lleg convert himn primer nazism despues band ali 1936 norbert schultz pianist cabaret pus music letr escrit años atras sold aleman tres años tard grab disc bell mediocr cantant lal anders consigu exit popular tal servici propagand terc reich decid hac cancion	Drama
paul javal michel piccoli autor dramat frances acept reescrib escen odise pelicul va rod capri baj direccion renombr director aleman fritz lang fritz lang prim encuentr productor arrog norteamerican prokosch jack palanc escritor dej muj bell camill brigitt bardot vay coch productor finc este da lug grav mal entend escritor espos cre ofrec moned cambi obten mejor pag consecuent situacion escritor ver inmers dolor crisis matrimonial	Drama
noch fatal victor chic fortun acud busc elen pis despues hab conoc encuentr sexual fortuit alli coincid dos polic armad produc malentend suen par dispar dav agent cae suel qued inval siempr elen sint culpabl suces cambi vid acab cas victor va par carcel sal todav obsesion elen insist acerc desencaden enred pasional mezcl amor cel violenci	Drama
atorment hab vist mor padr delant bruc wayn enfund cad noch traj batm adopt terrorif form murcielag surc tej gotham city combat crim manten ray corrupcion ciud vez batm enfrent terribl enemig jok pretend somet tod ciud baj dese ment perturb	Fantasía
michel poiccard ex-figur cin admir bogart tras rob coch marsell ir par mat fortuit motor polic remord algun acab hac prosig viaj par tras rob diner amig busc patrici jov burgues american aspir ser escritor vend new york herald tribun camp elise sueñ matricul sorbon escrib algun dia period europ cre hab hall libert conoc amer michel ignor polic busc muert motor	Drama
fiscal nuev orleans jim garrison reabr cas asesinat president unid john kennedy present carg person despues entrevist numer testig dall person relacion hech mantuv tesis magnicidi frut conspir podr hab interven fbi cia propi vicepresident lindon johnson	Drama
rony viv feliz castill padr encuentr nuev compañer jueg birk bosqu oscur cercan dos explor desiert desafi peligr witchbirds rump-gnom famili descubr birk ronj jug junt prohib volv vers hech padr competidor jef ladron enemig amarg ahor dos niñ valient deb intent derrib barrer manten famili separ tiemp	Aventura
¿com cambi hombr mund pregunt obsesion bruc wayn igual fantasm padr muert tir ojos call gotham noch camb vid siempr atorment culp ira desilusion hereder industrial desaparec gotham viaj secret mund busc medi luch injustici utiliz mied aprovech mied ayud leal mayordom alfred detectiv jim gordon poc buen polic fuerz orden public gotham lucius fox ali division cienci aplic wayn enterpris bruc wayn liber imponent alter ego batm justicier enmascar utiliz fuerz inteligent desplieg artefact alta tecnolog combat fuerz siniestr amenaz destru ciud	Acción
fus miembr tokkitai cuerp motoriz vigil armad especial llev tiemp plant trabaj parec convert maquin mat noch patrull top miembr sect organiz terror fus apunt jov bomb disp	Animación
fbi busc bill asesin seri mat victim tod adolescent despues prepar minuci arranc piel pod atrap recurr claric starling brillant licenci universitari expert conduct psicopat aspir form part fbi sigu instruccion jef jack crawford claric visit carcel alta segur gobiern mantien encerr hannibal lect antigu psicoanal asesin dot inteligent superior normal mision intent sac inform patron conduct bill	Crimen
hombr apoc tim cas hij millonari impid disfrut fortun decid contrat dos delincuent secuestr muj fin mont negoci propi diner rescat seri azar circunst secuestr sum tres brutal asesinat oblig polic interven	Crimen
jan daniel brühl pet stip erceg jul juli jentsch disfrut rebeld juventud une pasion cambi mund conviert the edukators cuy accion violent trat avis ric local dias abund cont complic aparec jul enamor ambos joven ademas oper complic conviert rapt intencion acab pon car car ley	Drama
sigl dos raz ido evolucion profund tierr aristocrat sofistic vampir brutal hombres-lob lycans cuy existent siempr form part mund mit leyend raz nocturn enemig mortal conden viv perpetu guerr sol sobrev medi conflict ancestral guerrer vampir selen descubr conspir lycan secuestr michael jov medic despues segu tod ciud selen entabl insolit relacion lycans decid atac interpon medic mientr intent salv michael descubr plan lycans cre nuev criatur combin poder ambas raz carezc debil proyect hac realid favorec hombres-lob	Fantasía
acus asesinat muj andrew dufresn tras ser conden caden perpetu envi prision shawshank pas años consegu gan confianz director centr respet compañer presidiari especial red jef mafi soborn	Drama
antoni salieri music destac cort emper jos ii austri entreg complet music promet dios humild castid si cambi conserv extraordinari dot musical despues lleg cort jov llam wolfang amadeus mozart salieri qued releg segund plan irrit perd protagon har posibl arruin carrer jov music mientr mozart ajen maquin salieri sorprend genial music excentr	Historia
pas once años sarah connor marc objet ser elimin cyborg futur ahor hij john futur lid resistent objet terminator modern mortifer vez resistent ingeni envi protector vuelt pas intent salv john madr sarah	Acción
falt dos dias lleg año 2000 call angel abarrot gent lenny sid expuls brig antivici dedic captacion client vend clips reproduc vivenci person	Crimen
asesin niñ atemoriz tod ciud polic busc frenet desesper deten cualqui person minim sospech part jef hamp furios red sufr culp asesin decid busc mism	Drama
umbert domen ferrari jubil intent sobreviv miser pension sum pobrez viv pension cuy dueñ maltrat consig reun diner necesari pag alquil habit unic amig mund jov cri perr flik	Drama
c.c baxt modest ambici emple compañ segur manhatt solter viv sol discret apartament prest ocasional superior cit amor esper favor sirv mejor posicion empres situacion cambi enamor ascensor result ser amant jef usan apartament	Comedia
sigu estel suced pirat carib cofr hombr muert encontr her will turn elizabeth swann ali capitan barboss busqued desesper liber capitan jack sparrow man davy jon mientr terrorif barc fantasm holandes errant baj control compañ indi oriental caus estrag larg siet mar will elizabeth naveg medi traicion felon mar salvaj deb segu adel rumb singapur enfrent astut pirat chin sao feng ahor mismis confin tierr deb eleg band batall final sol vid fortun sin futur pirat clasic pend hil	Aventura
vid sec narr histori famili fabian muj sinh vitori dos hij serta años cuarent realiz epoc gran agit polit social visper golp iba instaur dictadur milit brasil titul mayor cin latinoamerican filmaffinity	Drama
novat robbins viej glori beisbol costn disput amor madur atract anim equip sarandon cad primaver anni forof equip beisbol bufal durham elig jugador educ cam camp jueg tempor dos candidat veteran novat ambos cualidad suel suced siempr decid filmaffinity	Comedia
will kan gary coop sheriff pequeñ puebl hadleyvill acab contr matrimoni amy grac kelly recien cas proyect traslad ciud abrir pequeñ negoci repent empiez corr puebl notici frank mill ian macdonald criminal kan atrap llev justici sal carcel lleg puebl tren mediod veng kan tiemp va pas lent nadi puebl dispuest ayud sheriff	Western
segund guerr mundial casablanc ciud lleg huyend nazism gent tod part lleg facil sal casi impos especial si nombr fugit figur list gestap ocasion principal objet polic secret aleman lid chec hero resistent victor laszl cuy unic esper rick blain propietari ’ s caf antigu amant muj ilsa ilsa ofrec qued cambi vis sac laszl pais rick deb eleg propi felic ideal rig vid pas	Drama
1941 barton fink viaj hollywood escrib guion luchador wallac berry vez instal hotel earl guionist sufr agud bloque mental vecin habit jovial vendedor segur trat ayud seri circunst advers hac sient cad vez incapaz afront trabaj	Comedia
documental surf relat primer raic polinesi renac comienz sigl xx desarroll ancho larg cost californi part años 40	Documental
chappell quier hac fiest amig music admir decid recurr metod antigu convencional boc boc megafon invit personal vecin señor almacen peluquer niñ escuel conoc television quier ¿el siti escog callejon cualqu barri	Comedia
aunqu norm paul mcle hij pastor protest recib rig educ tambi disfrut libert norm jov juicios reserv profesor enamor paul cambi extrovert dedic period llev vid desorden pes siempr mantendr unid rio salvaj atravies montan aprend pesc	Drama
1959 vivi bell profesor literatur ingles matrimoni futur lleg ren nev tramit divorci maner rap alli aloj ranch turist conoc cay chic lesbian ambicion trabaj casin ambas pas cad vez tiemp junt consigu vivi vuelv sent viv nuev	Drama
inspir novel homonim patrici higsmith viaj tren guy jov campeon tenis farley grang abord brun walk jov conoc vid milagr traves prens inesper propon dobl asesinat intercambi victim fin garantiz reciproc impun asi podr resolv respect problem suprim muj guy quier conced divorci cambi guy deb asesin padr brun este pud hered gran fortun viv air	Crimen
pas dec john connor salv human destruccion actual john 25 años viv clandestin ningun prueb documental existent asi evit ser rastr skynet sofistic corpor maquin vez intent acab vid ahor futur sid envi t-x maquin destructor cyborg desarroll skynet mision complet trabaj pud termin predecesor t-1000 t-x maquin tan implac bell aspect human ahor unic esper sobreviv connnor terminator	Acción
william parrish poder meticul magnat cuy vid ve alter lleg enigmat jov llam joe black enamor hij trat realid personif muert mision cumpl dich hog version film 1934 muert vacacion	Fantasía
danny oce band sol razon realiz golp ambici arriesg defend willy bank despiad propietari casin nunc imagin iba pon traicion reub tishkoff amig mentor danny oce bank equivoco… desgraci quizas pud derrot miembr original band dej demas pie dio proposit compart derrot bank noch gran inaugur nuev casin	Crimen
once amig compañer armas ii guerr mundial 1939-1945 plan rob sol noch cinc mayor casin veg año 2001 stev soderbergh hiz remak gran repart georg clooney brad pitt juli roberts	Crimen
stephan garc bernal jov diseñ mexican tim introvert cautiv propi sueñ siempr trat despert control imagin amenaz suplant mund real vid present oportun cambi madr frances convenc vuelv cas natal par promet trabaj decepcion grand comprueb trat rutinari trabaj pequeñ oficin compart tres singular compañer especial excentr guy alain chabat embarg decepcion desaparec conoc vecin stephani charlott gainsbourg amig zoe emma caun	Comedia
sheriff chanc john wayn encarcel asesinat herman poder terratenient cuy hombr intent liber imped chanc cuent colabor dos ayud alcohol dean martin viej tull walt brenn une jov habil pistoler llam color ricky nelson qued encerr carcel oficin sheriff roed increment tension puebl esper lleg autor estatal llev deten	Western
sarah morton charlott rampling escritor britan autor libr misteri novel policiac viaj londr sur franci pas dias cas editor charl danc intencion descans encontr inspir nuev novel alli conoc hij adolescent anfitrion atract convencional juli ludivin sagni	Crimen
tras segund guerr mundial 1939-1945 padr alici huberm espi nazi conden traicion unid despues juici alici da fiest aparec apuest desconoc llam devlin trat agent servici inteligent reclam colabor atrap alexand sebasti cerebr nazis brasil principi muestr reaci final acced enamor atract agent american vez brasil alici gan simpat sebasti va viv cas implic asunt acab pon peligr vid	Suspense
stanley ingenu emple banc incapaz enter cuand aprovech jef mangone caser humill sol perr parec ser capaz aguant amig charli invit ir cabaret coc bong intent estimul consegu espabil ocurr aparec bell tin carlyl entra banc habl stanley pas fotografi caj fuert mini cam entonc stanley encuentr masc da grand poder quit mied ahor libr actu quier	Romance
octubr 1993 sold american elit envi mogadisci somali mision paz nacion unid fin supon salv vid seg result principal objet mision captur caudill aid acab raiz guerr principi parec ir bien dos helicopter black hawk aparent invenc derrib entonc mision conviert desesper carrer rescat tripul sold tierr qued atrap result her accident	Acción
detectiv detroit axel foley emple coraj persegu despiad asesin ayud viej compañer serg billy rosewood investig conduc popul parqu temat angel wonderworld alli repentin axel conviert nuev atraccion lug bien qued colg arañ gigant rescat niñ disfraz okey dokey enorm elef azul	Acción
segund guerr mundial 1939-1945 rom ocup nazis temibl gestap trat arrest manfredi lid comit nacional liber anni mari ofrec refugi cas manfredi camar aleman descubr escondrij rod viviend partisan consig escap tej manfredi apres	Drama
original extravag revision mit don juan despues ser abandon ultim conquist delpy don johnston bill murray recib cart anonim inform hij tan inesper notici impuls emprend viaj busc antigu amant resolv misteri	Comedia
klingenfeldt famili alta burgues danes dispon celebr sesent cumpleañ patriarc hombr trayectori reput intach embarg tres hij aunqu diferent dispuest aprovech ocasion sac reluc trap suci famili	Drama
tras pas peor dí vid descontent reporter televisión bruc nol consig pod divin pues recrimin dios ide cóm está llev asunt tal desafí dios decid darl poder ver si capaz hac mejor él	Fantasía
dav aaronson noodl pobr jov judi conoc suburbi principi sigl xx manhatt nuev york maximili bercovicz max jov orig hebre dispuest lleg lej cualqui metod entabl gran amist form 3 coleg noodl patrick goldberg patsy philip stein cockey dominic band prosper rapid desgraci persegu bugsy tip noodl amig trabaj anterior asalt mat dominic rapid noodl tir encim mat pas 12 años prision noodl sal prision recib max sig band junt 2 amig patsy cockey rapid 4 lleg convert tiemp prohibicion mayor ganster pais	Drama
juguet andy niñ seis años tem lleg hor nuev regal cumpleañ sustitu corazon dueñ woody vaquer sid ahor juguet favorit andy trat tranquiliz aparec buzz lighty hero espacial dot tip avanc tecnolog woody releg segund constant rival transform gran amist ambos pierd ciud sab com volv cas	Animación
alex hug ingles madur taciturn lug ontari dia emprend viaj visit madr hij muert	Romance
patienc philips hall berry muj sumis siempr dispuest agrad gent trabaj diseñ gráfic gigantesc laboratori cosmét hedar beauty dirig despót georg hedar lambert wilson espos supermodel laurel sharon ston tím patienc enter casual siniestr secret revolucionari product antienvejec compañí pront va sal vent ve envuelt conspiración just entonc salv muert renac fuerz veloc agil agudís gat nuev vid venganz catwom guiará misteri muj llam opheli powers franc conroy	Acción
bailarin gog tres chic tras dur noch trabaj gust mont coch pis fond busc problem asi medi desiert encuentr jov parej ret carrer acab mat secuestr continu gasoliner encarg cuent medi desiert viv dos hij viej escond enorm fortun dud chic dirig cas averigu dond diner filmaffinity	Acción
chris locutor radi cas segund nupci katrin uwe propietari pequeñ restaur pas cas ellen cuatr rond cuarenten viv ciud tan insuls depriment frankfurt-od antigu alemani democrat chris intim amig uwe katrin amig intim ellen impid buen dia chris ellen comienc aventur sentimental ser descubiert har salt air aparent perfect univers pequeñ burgues dos parej mism tiemp hech invit cuatr replant existent analiz aciert error pas aprend valor dese descubr pequeñ sencill placer cotidianos… palabr volv viv final result frankfurt-od ciud tan depriment simpl gait pued cambi	Comedia
esma quier hij sar doc años oportun particip viaj organiz colegi bast certific prob padr mur mart guerr sal mit preci esma siempr da larg sar pid certific parec prefier remov ciel tierr encontr diner pag preci viaj convenc proteg mism hij si cuent verd	Drama
band margin viv miser antro angel hotel millon dolar elois tom protagon enamor loc muert izzi roth har padr import personaj television pong march investig acall rumor suicidi podr dañ reput	Drama
jov solitari clarenc celebr cumpleañ siempr hac viend pelicul kun-fu destartal cin detroit cun rubi explos alabam hac entrad sal derram palomit incident surg loc aventur amor llev dos joven viv verdader noch pasion alabam realid prostitut alquil mejor amig clarenc regal cumpleañ dos joven enamor contr matrimoni clarenc intent alej muj prostitu enfrent chul ir recog pertenent alabam abrir malet encuentr consider cantid cocain utiliz esper realiz sueñ deseador	Acción
will dorm veteran detectiv angel viaj pequeñ puebl alask compañer hap investig asesinat chic 17 años angel qued pendient oscur asunt incumb dos vez alask entran contact principal sospech walt finch novel ermitañ	Crimen
jov gay intent irse viv novi entromet padr enter	Comedia
jimmy markum penn dav boyl tim robbins devin kevin bacon niñ crec junt peligr barri obrer boston pas dias jug hockey call dia dav ocurr marc siempr vid amig veinticinc años tard tragedi vuelv unir asesinat kati emmy rossum hij 19 años jimmy polic asign cas pendient jimmy desesper intent tom justici man	Suspense
principi sigl xx narr histori celi adolescent negr catorc años embaraz propi padr hombr despot cruel part entonc vid llen dolor humill	Drama
divorci espos catalin aragon hij rey catol tia emper carl v contr matrimoni ana bolen enriqu viii 1509-1547 trat obten apoy aristocraci cler sir thom mor gran human utop 1516 fervient catol hombr confianz monarc encuentr encrucij ¿deb actu acuerd concienci arriesg ser tach traidor ejecut deb ced rey ningun repar adapt ley neces	Drama
lily encuentr tren shanghai antigu amor capitan harvey larg trayect rod grup personaj variopint llen vicisitud inclu asalt tren grup rebeld daran cuent nunc dej amars	Aventura
agent fbi escolt testig hawaii angel intent dich testig testifiqu asesin liber cient serpient venen avion comercial plen vuel agent fbi pilot novat tripul aterroriz intent sobreviv mortal invasion	Acción
yamamot yakuz viaj angel encontr herman pequeñ ken proteg financi mediant ingres criminal lleg alli descubr ken realiz unas oper trafic drog demasi futur yamamot decid ayud mostr com tom baj fond angel estil mafi japones dec usand maton profesional bas accion estrict codig honor choc mental criminal norteamerican	Crimen
ponch director helmut weiss bas novel homonim heinrich spoerl hans reimann convert pelicul aleman cult pelicul cuent histori escritor johann pfeiff infiltr estudi escuel secundari despues amig dijer perd gran experient vid educ cas	Comedia
multimillonari john hammond ide espectacul parqu temat isla retir visit pued observ dinosauri real ultim tecnolog desarroll adn cientif pued clon braquiosauri triceratops velociraptors tiranosauri rex utiliz ello sangr fosiliz ambar conten insect mord hac millon años paleontolog alan grant elli sattl ian malcolm visit parqu qued sorprend result obten problemat emple manipul sofistic sistem segur dinosauri escap oblig visit luch supervivent	Aventura
pas cuatr años devast parqu juras dr malcom punt descubr sobreviv isla cost ric pertenecient cost cinc muert dinosauri viv reproduc libert trat llam zon b lug serv laboratori genet despues john hammond llev empres bancarrot sobrin pet tom riend dispuest levant compañ explot peligr zon	Aventura
doctor alan grant ansios consegu fond financi estudi inteligent velociraptor acept ofert parej millonari paul amand kirby sobrevol isla sorn puert ric pobl dinosauri cre genet parqu recreat tras produc aterrizaj forzos isla alan descubr kirby busc hij adolescent perd isla tras accident parapent	Aventura
john brown inocent guardi segur sueñ ser mejor agent polic mund accidental camin cruc malv sanford scolex dad muert hospital brend bradford implant cuerp 14.000 disposit facil utiliz brown despiert transform inspector gadget maquin perfect prepar luch crim bas seri dibuj anim tv años ochent efect especial stan winston	Acción
rahul jov guap ric indi canadiens desesper consegu famili dej entromet vid priv des cabez dej solt rahul parec decid ello herman ademas tampoc recib aprob padr dese cas jov cantant pop tampoc agrad famili dia rahul desesper conoc sue bar tipic muj compañ ve solucion problem contrat hac ver realment novi filmaffinity	Comedia
pelicul const nuev tram paralel lug vall san fern angel niñ prodigi present concurs television ex-niñ prodigi moribund hij perd muj enfermer moribund histori aparent independient guard extrañ relacion magnoli retrat vid american vist traves seri viñet comic conmovedor	Drama
mientr constructor ferrocarril avanz impar desiert arizon camin haci mar jill lleg pequeñ puebl flagston intencion empez nuev vid	Drama
juan mirand john mallory veteran ira conoc mexic plan trabaj junt rob banc dia dinamit cre banc local result ser prision explosion liber revolucionari pres ambos conviert her revolu tiemp despues trop gobiern comand coronel gutierrez comienz segu pas	Western
par años sesent mom adolescent judi resuelt independient viv padr hurañ depres barri popul trab entrañ amist señor ibrahim ancian musulman propietari pequeñ tiend ultramarin	Drama
berlin octubr 1989 dias caid mur madr alex muj orgull ide comun entra com despiert ocho mes despues hij har posibl impos enter viv alemani reunific capital objet convert apartament famili isla anclad pas especi muse social madr viv comod creyend cambi	Comedia
pelicul divid histori independient traves cual jim jarmusch present panoram nocturn cinc grand ciudad angel nuev york par rom helsinki taxi ocurr anochec amanec mism dia obvi diferent personaj hil conductor	Comedia
jov judi norteamerican wood lanz busqued muj aparec fotograf junt abuel pequeñ puebl ucrani natal	Comedia
vid vincent sol volv ten dia asesin muj deten vecin alic convenc pued devolv felic decid invent culpabl fictici vincent pued veng dej atras pas	Crimen
tobi robert stadlob achim kostj ull-mann amig hac años timonel remer equip rem celebr numer victori pas esper impacient disput gran regat region trat campament veran dej ser niñ vuelv seri flirte achim sandr miriam morgenstern tobi da cuent sentimient achim profund quier admit confus incomod cad vez exclu lug equip femenin berlines tan esper lleg equip joven homosexual hac gal condicion repent tobi compañer ven oblig replant prejuici mied quien sab si dese secret med sub tension confront muchach parec tan inevit violent torment amenaz desat lag	Comedia
comedi negr relat histori jov buen famili obsesion muert punt pasatiemp favorit prob diferent metod suicidi obtuv excelent critic	Comedia
vendedor arte marginal viaj chicag carolin nort reun nuev famili polit desafi asi equilibri cas clas medi sur	Comedia
william harford respet medic neoyorquin cuy vid parec ir bien cas precios muj hij trabaj gust dia siguient asist fiest espos alic habl unas fantas erot com punt romp matrimoni desconoc abrum confesion acab entrand local antigu compañer habl congreg secret dedic hedon plac limit part entonc mund domin sex erot abre	Drama
band foraj atemoriz habit pequeñ puebl saqu period pied repel ataqu aldean decid contrat mercenari final consig servici 7 guerrer 7 samurais dispuest defend cambi tan sol cobij com	Acción
pelicul espiritu documental intent retrat vid cotidian berlin 1930 ello utiliz pequeñ histori ficcion dos hombr dos mujer pas jovial jorn doming ciud	Drama
regres tierr nav carg nostrom interrump viaj despiert siet tripul orden central madr detect misteri transmision form vid desconoc procedent planet cercan aparent deshabit nav dirig entonc extrañ planet investig orig comun	Terror
obra maestr tragic poetic melodramat griffith histori jov viv barri londinens limehous encuentr atrap ambient violenci padr rud malhumor boxeador aficion beb maltrat ces testig ello jov nobl tender inmigr chin enamor trat ayud darl cobij	Drama
vertigin mund mod nuev york revist sant grial dirig puñ hierr eleg manicur mirand priestly trabaj temibl ret aquel quier triunf mund hac ayud mirand podr abrirl cualqui puert andy sachs recient gradu chic destac desaliñ dentr pequeñ ejercit guapisim redactor revist andy comprend pront triunf negoci va necesit inici determin prueb definit delant vest prad pies cabez	Comedia
pobr vagabund charl chaplin pas mil avatar consegu diner ayud pobr chic cieg virgini cherill enamor	Comedia
plataform marin perd niebl malv krank envejec prematur pues carec cualid esencial facult soñ razon rapt niñ ciud rob sueñ compañer infortuni irvin cerebr flot dentr acuari señorit bismuth band clonic lad niebl ciud portuari encuentr one fuerz naturalez ingenu extraordinari valient busc herman pequeñ desaparec	Fantasía
impuls luk jackson sid conden dos años trabaj forz delit romp plen borracher post aparc vid penal durisim conviv pres conden delit grav ademas violenci pres carceler convert habit impos erradic luk veteran guerr dispuest ced pag alto preci segu siend	Crimen
ibo jov turc segund gener hamburg imagin gran admir bruc lee cuy sueñ ser prim director pelicul kung fu alemani deb conform rod spot restaur kebab tio conviert celebr barri embarg vid dar gir radical novi aleman titzi comun embaraz padr echan cas madr futur niet turc ademas ibo panic ser padr ten cambi pañal asi titzi dej sol qued coleg spots tampoc asunt cos march exces bien	Comedia
lulu louis brooks muj ambici moral usa hombr volunt desinhib atract aprovech encant conllev peligr obra mayor expresion encumbr louis brooks joy cin mud adapt magistral obra teatral lulu wedeking	Drama
gilli holroyd kim novak miembr sag hechicer encuentr tia queeni elsa lanchest herman nicky jack lemmon enamor loc famos editor sheperd henderson jam stewart punt contr matrimoni jov bruj dud utiliz conjur consegu sheperd dej promet rind encant sal segun previst despues gilli confies verd poder shepherd indign pid ayud extravag señor pass romp hechiz tia queeni tom cart asunt intent utiliz poder magi reun parej amor	Comedia
rusi revolu bolcheviqu 1917 guerr produc convulsion general pais divid medi conflict asist dram intim hombr luch sobreviv hombr zhivag poet cirujan mar amant cuy vid trastorn guerr afect vid inclu tony muj lar muj enamor	Drama
qing cheng pobr niñ huerfan rob com vest muert pod sobreviv dia mientr huy niñ rob encuentr dios hac tentador propuest convert hermos princes tip riquez volv pas hambr cambi jamas podr encontr amor verdader pues cualqui hombr ame termin dias maner tragic qing cheng piens demasi acept trat conform años pas arrepient decision tom pues tal sentenc dios hombr ama termin sufr desdich	Fantasía
año 1903 matrimoni smith afinc san luis cuatr preci hij esther diecisiet años enamor vecin acab instal ciud embarg famili especial esther enorm disgust padr anunci deb traslad viv nuev york motiv trabaj	Comedia
detectiv philip marlow investig ocurr cadav sid rescat muell lid famili contrat resolv cas hij atract marlow enamor remision	Crimen
divert comedi fields control casi absolut apart ser protagon actor firm guion curios seudonim mahatm kan jeev realid tram complet disparat casi mer excus acumul gags personaj egbert sous especi ego fields men imag gran public actor da vid borrachin casual detien atrac banc part ahi nac fulgur carrer detectiv practic pes pues inclus intent particip estaf filmaffinity	Comedia
thom crown millonari boston hombr hech mism aburr vid llev huir rutin prep golp perfect rob banc march despues brasil reun grup delincuent deposit tres millon dolar banc suiz da golp dej pist esclarec cas ocup investig compañ segur	Crimen
despues hab intent suicid cahit turco-aleman cuarent años alcohol toxicoman sid ingres plant psiquiatr consig acostumbr dorm drog alcohol sibel guap chic turc 20 años nac hamburg gust demasi vid ser buen musulman intent suicid huir carcel rej human famili creyent respetu tradicion levant alrededor vez frustr suicidi sol ve posibil liber famili cas cahit	Drama
gotham city enfrent dos nuev peculiar criminal diaból siniestr pingüin criatur solitari extrañ deform hermos seductor letal catwom batm deberá enfrent pingüin quier convert amo ciud	Acción
shin-a jeon do-yeon jov profesor pian acab qued viud quier empez nuev vid hij jun miryang puebl natal difunt mar cerc seul shin-a abre academi pian busc tierr cultiv prepar afront valient vid tod expect futur derrumb nuev tragedi aparec vid filmaffinity	Drama
frank bullit detectiv polic san francisc ambici polit encarg protej fugit persig sindicat crim chicag embarg bullit pued evit asesin part moment deb investig cas minuci hall clav misteri	Acción
radh nargis ahor ancian muj recuerd pas vid cas famili trabaj dur pag prestam mar radh raj kum pierd braz accident desatiend famili cri sol niñ filmaffinity	Drama
walt davis ejecut adict trabaj dedic tiemp vid priv dia necesit acompañ ir cen negoci client japones herman propon ir acompañ nadi chic nuev ciud	Comedia
nuev raz vampir surg oscur acech sedient sangr busc nuev victim guerr silenci vampir human estall organiz secret sid design limpi mund amenaz mejor agent encuentr misteri muchach llam say cuy caract fri calcul conviert mejor cazador vampir	Animación
aspir campeon carrer ray mcqu via rap exit fam soñ error tom desvi inesper polvorient solitari rut 66 actitud arrog desvanec lleg pequeñ comun olvid enseñ cos import vid olvid	Animación
bas histori real despues hab retir boxe jam braddock decid volv cuadrilater años gran depresion pod aliment famili boxeador talent coraj sacrifici dignid llev cumbr	Romance
william blak decid abandon puest contabl cleveland ohi despues recib ofert trabaj machin inhospit ciud industrial oest eeuu embarg lleg result puest ocup person charli dickinson hij propietari empres mat muj encuentr cam blak vez liqu charli mod simpl contabl cleveland conviert fugit persegu tres cazador recompens	Drama
epidemi hac resucit muert convert ser avid carn human extend lleg punt vari ciudad qued practic desiert supervivient deb refugi zon militar zombi dud acab propi familiar continu clasic horror georg romer noch muert vivient night of the living dead 1968	Terror
remak clasic horror georg romer inexplic plag diezm poblacion planet convirt muert horribl zombi continu busc carn sangr human sobreviv wisconsin variopint grup person escap plag trat salv vid refugi centr comercial deb aprend sol proteg hord zombi sin conviv	Terror
barri humild brooklyn bedford stuyvesant conviv atropell vari famili raz negr hispan parej comerci vietnamit famili italoamerican pizzeri mooki chic trabaj repartidor pizz testig privilegi personaj hech cotidian lug barri asi tension actitud racist habit	Drama
galaxy quest titul seri television emit gran exit treint años vez dej emit protagon dedic pas antigu uniform convencion program especial sab raz alienigen espaci exterior thermians capt seri creyend trat document histor luch pervers roth h'ar sarris decid secuestr protagon ayud combat	Comedia
vari joven pequeñ local habitual pesadill persegu hombr deform fueg usa guant termin afil cuchill comienz ser asesin mientr duerm ser result ser asesin padr joven quem viv hac vari años tras descubr asesin vari niñ	Terror
h.i nicol cag edwin holly hunt parej pued ten hij dispuest form famili cuest cuest decid secuestr beb famili acab ten quintilliz	Comedia
año 1929 dos amig surg gran rival caus amor muj leo gangst domin ciud tom lugartenient enfrent guerr abiert desencaden traicion conflict polit corruptel escision intern	Drama
charli babbitt jov corazon esper recib consider herenci tras muert padr distanci embarg algui charli absolut cuent herman mayor raymond reclu institu medic recib tod fortun testament raymond autist capac mental limit aspect dot geni	Drama
pes john robi gat ladron joy reform conviert principal sospech seri rob piedr preci lujos hotel riv frances asi remedi demostr inocent conoc caprich hereder franc ve oportun desenmascar misteri ladron utiliz señuel fabul joy madr jov	Crimen
prim film produc alemani tras segund guerr mundial auspici recien cre estudi def hombr muj regres berlin ruin muj susann walln supervivient camp concentr pes horror sufr dese reinici vid regres apartament encuentr hans mertens viv ahi medic atorment memori rol guerr	Drama
prim larg gus van sant rod blanc negr cam 16 mm presupuest apen 25.000 dolar walt treintañer gay dueñ tiend aliment enamor johnny jov inmigr ilegal mexican heterosexual habl ingles aunqu indiferent walt johnny acept dorm diner filmaffinity	Drama
despues cumpl cinc años conden tony stephanois sal prision intencion cambi vid encuentr antigu amant conoc gangst asi cos carec recurs econom qued remedi volv vid pas reun viej compinch seman prep minuci golp perfect atrac inacces joy par	Drama
convenc comun contamin unid general orden acces locur ataqu aere nucl sorpres union soviet ayud capitan mandrak trat encontr formul imped bombarde part president ee.uu pon contact moscu convenc gobiern soviet ataqu estup error mientr asesor estadounidens antigu cientif nazi doctor strangelov confirm existent maquin juici final disposit represali soviet capaz acab human siempr	Drama
seductor princes dal claudi cardinal lleg precios panter ros magnif joy form felin lujos hotel conoc eleg amabl sir charl dav niv baj cuy inofens aparient ocult embarg despiad ladron profesional conoc fantasm imped astut delincuent salg encarg inspector torp polic frances men famos jacqu clouseau pet sellers	Comedia
submarin aleman segund guerr mundial escenari grup joven sold dispuest defend patri somet dur convivent tras descubr sid envi realiz mision probabl suic	Drama
enfrent dur polic inteligent atrac tens secuestr rehen banc manhatt segun desarroll peligr jueg gat raton aparec tercer person sid contrat influyent propietari banc trat madalin poder brok agend secret	Crimen
tras escuch testimoni valor prueb present jur popul compuest doc hombr decid unanim si absuelv conden muert jov acus hab mat padr principi once complet convenc culpabil inclin conden discrep empiez plant dud razon van resquebraj inicial segur demas	Drama
homenaj wim wend lisbo cin ingenier son recib postal amig moment rod pelicul lisbo deb atraves europ encontr prest ayud	Drama
tras muert juarez mexic domin injustici terror joe pistoler vagabund lleg puebl fronteriz san miguel dos famili disput control territori entra servici clan roj noch joe testig intercambi oro armas mexican sold union	Western
lansquenet puebl frances tradicional cambi ultim cien años vient nort llev consig dos foraster viann roch hij anouk viann inaugur chocolat replet dulc capac despert ocult apetit habit puebl pose ademas don especial permit percib dese demas satisfac dulc exact	Comedia
tras elimin miembr band intent asesin dia bod mamb negr prosig venganz intent acab rest band especial antigu jef bill dio muert dej com	Acción
parej polic form martin riggs rog murtaugh vuelv carg enfrent cap mafi asiat extend activ angel investig ayud jov polic respons quebrader cabez familiar murtaugh dej embaraz hij cas riggs cos complic compañer esper hij amenaz hac pas altar	Acción
descubr antigu piramid enterr baj hiel antart hac acud continent hel equip cientif aventurer vez alli hac descubr aun aterr dos raz extraterrestr guerr gan gan perd increibl terrorif aventur comienz millonari industrial charl bishop weyland reun equip internacional arqueolog cientif expert segur dirig especial medioambient aventurer alex lex woods investig unas misteri eman calor surg profund antart	Aventura
georg marth matrimoni profes odi salvaj ambos personal autodestruct conoc perfect debil sab com exasper georg profesor histori alcohol marth hij director univers georg da clas muj frustr vulner sab noch despues fiest invit cas nuev profesor espos presenci parej evit marth georg humill maltrat costumbr traves cruel jueg sal reluc verd anfitrion invit	Drama
kat chic convencional sueñ cas novi charli ser feliz siempr problem charli enamor juliett bell frances viaj negoci par dispuest recuper kat vuel capital frances avion conoc luc ladron parec ten comun situacion kat complic aduan luc met de cuent coll rob bols sab com kat ve viaj tod franci descubr junt luc encant pais	Comedia
capot pelicul escritor trum capot investig realiz escrib sangr fri libr bas hech real philip seymour hoffm gan oscar mejor actor interpret trum capot	Crimen
neil mccauley expert ladron filosof cons viv atadur pued constitu obstacul si cos complic band form criminal profesional tan cualific pued impresion inclus detectiv vincent hann hannah viv tan obsesion trabaj lleg inclus pon peligr relacion sentimental band mccauley prep golp definit equip hannah intent evit cad comprend versel ment brillant enfrent carrer	Acción
jimmy gangst retir apod sant nunc mat hombr palabr eleg armas jimmy viv existent tranquil ciud denv buen dia recib visit antigu jef este apod hombr plan propon ultim trabaj dar sust chic mantien relacion ex-novi hij llev cab tare jimmy reun viej compinch pierd nervi cos acab mal	Drama
andrew largem braff vuelv cas natal nuev jersey despues diez años ausenci asist funeral madr alli rememor pas conoc chic samanth portm quiz pued cambi vid largem acab dej antidepres tom años comienz redescubr mism inclu enfrent padr psicolog ayud samanth super propi problem pisicolog	Comedia
antigu cantant rock sid brutal asesin ultim vez vio acompañ novi comis departament asunt intern nick curr recib encarg vigil catherin tromell supuest novi asesin	Suspense
miss daisy jessic tandy antipat profesor jubil 72 años decid compr coch hij dan aykroyd tem posibl caos circulatori peor aun accident contrat chof negr morg freem conduzc vehicul principi ancian tranquil conductor llev demasi bien	Drama
alvin straight richard farnsworth achac ancian viv iow hij discapacit sissy spacek ademas sufr enfisem perd vision grav problem cader casi impid permanec pie recib notici herman lyle stanton enemist hac diez años sufr infart pes precari salud decid ir verl wisconsin ello recorr 500 kilometr hac unic medi transport dispon maquin cortacesp	Drama
zampan artist ambul enviud compr gelsomin herman muj madr chic opong menor resistent pes caract violent agres zampan muchach atraid estil vid nom siempr call strad italian dueñ inclu espectacul aunqu vari pintoresc personaj va conoc deambul propon gelsomin mantendr fiel zampan ultim consecuent	Drama
tras caotic noch disturbi suburbi marginal par tres joven amig vinz hubert saïd deambul desocup esper notici salud amig comun result gravement her enfrent polic	Drama
hamburg crec junt hic amig gabriel turc bobby serbi cost grieg tiemp form pandill pequeñ delincuent embarg gabriel encarcel decid cambi vid sal empez trabaj empres herman bobby cambi relacion mafi albanes cost continu rob coch sueñ gabriel abrir cafet ide apoy alic novi bobby problem surg esta pid bobby alej baj fond gabriel intent persuad unic consig recib brutal paliz embarg inesper situacion dar vuelc	Crimen
malv madrastr princes blancaniev decid deshac pued soport bellez jov superior embarg blancaniev consig salv refugi cabañ siet enanit pes cruel madrastr consig encontr envenen manzan princes muert sol dorm esper princip azul rescat	Fantasía
final segund guerr mundial hombr her viaj caravan carreter itali tan grav qued monasteri deshabit semiderru encarg cuid han enfermer canadiens cuerp total quem consecuent accident sufr afric todav tiemp cont tragic histori vid	Drama
veran berlin katrin nik dos amig viv cas antigu berlin pis nik balcon pas noch enter charl katrin viv hij plant baj suspend ciel tierr instal balcon observ existent divers complej hombr reflexion acerc propi vid dese	Comedia
histori narr aventur cuatr herman lucy edmund sus pet segund guerr mundial descubr mund narni acced traves armari magic mientr jueg escondit cas camp viej profesor narni descubr mund increibl habit animal habl duend faun centaur gigant bruj conden inviern etern ayud leon aslan nobl soberan niñ luch venc pod bruj blanc ejerc narni espectacul batall consegu asi liber maldicion fri	Aventura
aventur solitari buscador oro alask top vari personaj rud enamor hermos georgi trat conquist	Aventura
detectiv priv abord misteri muj dic amenaz perseguidor hombr encarg proteccion aparec muert parec gir alrededor estatu halcon valor incalcul	Misterio
ciud gotham amenaz nuev vez trat malign parej compuest dos car enigm procur alter paz conciudadan mund enter siempr motiv bruc wayn deb enfund vez traj batm luch vez sol acompañ jov robin	Acción
experiment criogeni convert victor fri malv mr freez villan necesit manten cuerp temperatur gel ello intent congel habit ciud gotham lad tim botan pamel isley transform transcurs experiment terribl hiedr venen querr asesin ser human tierr plant recuper hegemon planet motiv batm robin deb enfrent deten siniestr plan	Acción
band atac arras cad año tierr granjer vari decid busc hombr pued defend consegu reun siet hombr cad cual presum caracterist especial	Western
haci año 75 crist esclav llam espartac vend escuel gladiador adiestr combat aren circ roman pront espartac lider rebelion maltrat sufr	Historia
delincuent poc mont decid atrac sucursal banc brooklyn embarg deb inexperient rob sid plan ser ejecut apen diez minut conviert tramp atrac espectacul television direct	Crimen
nichol jov dentist viv vid tranquil muj insoport acogedor cas lad montreal mund nichol sufr revolu aparec nuev vecin jimmy tulipan tem reput asesin sueld despues delat prision jef cap mafios yanni gogolack intent ahor empez nuev tranquil vid montreal suburban embarg intrig espos nichol acab plumaz sueñ oblig este vol chicag avis mafi jimmy montreal cobr asi recompens chivat nichol har cualqui cos alej muj acced llev cab plan creyend quizas asi podr reun diner suficient abandon desaparec	Comedia
cuatr histori gir torn matrimoni adulteri infidel infinit combin dich posibil filmaffinity	Comedia
tras prepar plan veng muert coleg man mitic tiburon blanc oceanograf stev zissou bill murray reclut tripul inclu espos anjel huston period cat blanchett jov podr ser hij owen wilson	Aventura
despues obten exit rotund director cin atravies crisis creativ intent inutil hac nuev pelicul situacion empiez pas revist hech import vid record tod mujer amad	Fantasía
varsovi 1939 pianist polac orig judi wladyslaw szpilm adri brody interpret tem chopin radi nacional poloni mientr aviacion aleman bombarde capital regim nazi invad pais hac pais invad llev cab mism polit respect judi asi szpilm tod famili padr herman dos ven oblig dej cas pertenec traslad mil person orig judi ghett varsovi mientr wladyslaw trabaj pianist restaur propied judi colabor nazis herman henryk ed stoppard prefier luch nazis tres años tard habit ghett traslad tren haci camp concentr	Drama
oskar schindl hombr enorm astuci talent relacion public organiz ambici plan gan simpat nazis despues invasion poloni aleman consig graci relacion nazis propied fabric cracovi alli emple cient operari judi cuy explot hac prosper rapid gerent judi verdader director sombr pues schindl menor conoc industrial	Drama
hac años tant 20.000 pequeñ ardirat nombr scrat quer escond bellot hiel hac provoc semicatastrof provoc animal migr haci sur haci tierr cal buen dic llev contrari trat mamut manfr autent lob solitari vagabund soberbi va haci nort sol demas yend haci sur	Animación
scotti fergusson detectiv polic san francisc padec vertig compañer cae vaci cornis mientr persig delincuent scotti decid retir gavin elster viej amig colegi contrat vigil espos madelein bell muj obsesion pas	Misterio
barri modern anodin exces organiz viv monsieur arpel espos hij gerard aburr soberan lleg tio monsieur hulot personaj soñador llen fantas alter mund tan asept tard convert mejor amig sobrin	Comedia
cuarent años miriam guap confianz segur tan ampli mar lind cas veran ningun tabu vid compart andre novi hij 15 años nils comprension toler nils invit novi doc años livi pas vacacion ningun problem descar sensual livi empiez flirt bill hombr mayor miriam decid acab relacion dudos	Drama
guerr secesion tres cazador recompens lanz busqued tesor ningun tres truhan pued localiz ayud dos tuc sab tesor encuentr cementeri mientr joe conoc nombr inscrit tumb escond mientr sentenz dud mat mujer niñ consegu met form tres hombr colabor aparient final intent elimin mutu	Western
c.r macnam alto direct destin berlin occidental recib encarg cuid hij jef visit macnam enter chic escap contraid matrimoni exalt jov comun jef vuelt tan sol veinticuatr hor qued remedi transform reaci revolucionari yern dign contrari pued desped ascens men tard dec dos tres plan escap man provoc incident internacional capaz enfad rus aleman peor propi espos mosc detras orej	Comedia
seis person desconoc despiert dia encuentr atrap prision extrañ surreal laberint fin habit cubic dot tramp mortal polic ladron profesional prodigi estudi matemat jov autist mezcl caprich personal exent perversion ningun sab porqu com lleg alli porqu pres ensegu surg obsesion grup huir planific sal tan horribl carcel mientr vari pregunt respuest ¿quien pod cre diabol laberint ¿quien encerr objet	Suspense
grup sold baj mand sargent raymond shaw comand benett marc sufr embosc guerr core captur ejercit enemig mes despues shaw recib medall honor gobiern unid entonc marc comienz sufr terribl pesadill relacion lav cerebr somet cautiveri core	Suspense
rein eduard vii 1901-1910 famili ingles form padr banquer madr sufrag dos niñ rebeld pretend llam atencion padr hac vid impos tod ver alter lleg mary poppins institutriz especial desciend nub emple paragu paracaid debut oscar juli andrews clasic cin famili dia bat records taquill niñer magic cancion pegadiz haran delici pequeñ cas	Comedia
harry callah dur polic cri call compañer llam harry suci particular metod luch crim siempr encarg trabaj desagrad san francisc francotir mat dos person harry encarg resolv cas	Acción
investig climatolog jack hall indic calent global podr desencaden repentin catastrof cambi climat tierr hall adviert dirigent polit neces adopt inmediat med evit advertent lleg demasi tard seri anomal fenomen climat empiez produc distint part glob calent global puest planet bord nuev glacial mientr jack adviert cas blanc inminent cambi climat hij sam amig encuentr atrap nuev york ido particip concurs academ institut	Acción
mar jov 17 años pequeñ poblacion nort bogot blanc trabaj gran plantacion ros prepar flor export unic distraccion mar bail acud cad fin seman novi juan dia sorpres famili abandon trabaj decid irse bogot nadi sospech mar embaraz viaj encuentr conoc habl lucrat trabaj corre trafic drog convenc amig blanc unan band	Drama
ocho person despiert encerr extrañ habit form cub sab com lleg ahi pront descubr ley fisic aplic extrañ mund asi descubr secret cub pod sobreviv	Suspense
precuel cub rains despiert laberint habit perfect cubic llev extrañ uniform gris codig barr tatu man recuerd nombr pront encontr prisioner laberint mism situacion med van desplaz cub iran mur tramp iran encontr rains admir secret trat wynn form part grup observ cuy trabaj control grup prisioner atra intent hac algun cos ayud univers cub nadi salv observ observ prisioner huy busc sal sab llev	Misterio
marcell rubini desencant period roman busc celebr muev insatisfaccion fiest nocturn celebr burgues epoc merode distint lugar rom siempr rod tip personaj especial elit socied italian sal enter sylvi celebr div mund cin lleg rom cre esta gran oportun consegu gran notici consecuent persegu noch diferent lugar ciud	Comedia
nav explor predator estrell aparec puebl color aliens bord escap mat predators except ultim predator supervivient deb ahor acab aliens asi terrorif pred-ali engendr anterior entreg mientr habit puebl siend inutil atrap medi ultim enfrent dos criatur mitic	Fantasía
cientif obses natural descubr hombr nac cri salvaj mientr cientif intent educ amant luch preserv instint simiesc hombr segun represent libert medi luch pod surg insolit triangul amor	Drama
pelicul mund cin keaton proyeccion sueñ ser detectiv milagr encuentr dentr pelicul proyect alli intent salv amad garr villan aclam cint cin mud llen gags visual portent bust keaton	Acción
andrew wyke prestigi escritor novel intrig ademas pasion jueg ingeni adivin llev convert gran mansion especi muse expon juguet mecan extravag tard invit cas mil tindl amant muj propietari caden salon bellez propon ingeni plan ambos podr sal benefici	Misterio
astrofis american dav sumn hoffm trasl viv puebl muj gran bretañ hombr reserv tim viv absort investig procur evit cualqui disput embarg violenci ciert individu puebl lleg tal extrem sumn situ espad par reaccion mism armas agresor defend muj hog obra clav filmograf peckinpah perr paj estudi violenci ser human bas novel the sieg of trench farm gordon williams	Drama
georg tipic burgues present program literari television llev vid acomod muj hij adolescent empiez recib paquet anon contien cint vide grab call dibuj inquiet cuy signific misteri sab quien envi embarg secuenci aparec cint hac cad vez personal sugier remitent conoc hac algun tiemp georg amenaz ciern famili puest evident delit algun polic nieg ayud	Misterio
rio oder sep sol dos ciudad dos pais sin dos mund diferent dos form viv grup person defect equivoc llen buen intencion luch encontr camin confus mund toc viv haran luz oscur	Drama
sam herman mayor michael tipic joven american interes normal instal tranquil ciud sant carl californi cos misteri empiez cambi personal michael transform madr gust ver convirt	Terror
enid rebecc dos rebeld adolescent amig hac años sab com pas rat ahor acab estudi secundari pes tim esfuerz encontr trabaj menud acab deambul call escrut comport gent rode atraid personaj excentr suel mir anunci personal period local enid llam autor anunci lament hombr solitari cuarent años coleccion disc invit cit cieg ambas acud restaur conven espi sab com vid	Comedia
suburbi par viviend proteccion oficial cam kechich sig grup chic viv batall tipic edad trat mir nuev fresc suburbi frances protagoniz recient unas violent revuelt puest jaqu socied frances	Romance
april burns kati holm jov modern 21 años emancip nid famili burgues instal ruinos apartament low sid nuev york compart novi color bobby amanec dia accion graci april invit famili cen pav nuev cas pas present bobby april nunc llev especial bien madr joy bobby convenc invit festiv thanksgiving si prepar encuentr suficient presion april descubr horn rot bobby misteri desaparec jov busc apartament edifici horn funcion mod april comienz conoc vecin entonc desconoc vei rellan filmaffinity	Comedia
ben alcohol cuy vid yend trast decid irse veg ciud bar nunc cierr beb mor alli conoc ser prostitut acept enamor sep reencuentr maravill histori dos person aprend acept com medi oscur pued surg pequeñ llam esper vid	Drama
grup amig reun intencion liber atadur moral socied imprim individu ello hac pas retard mental grup dedic enfrent socied idiotec	Drama
obsesion busqued ide matemat original brillant estudi john forb nash lleg princeton realiz estudi postgr muchach extrañ solitari sol comprend compañer cuart fin nash esboz revolucionari teor consig plaz profesor mit alici lard alumn dej fascin mostr ley amor encim matemat graci prodigi habil descifr codig reclut parch william departament defens ayud unid guerr fri union soviet	Drama
veron beach suced enfrent dos famili poder montesc capulet cuy objet consegu domini ciud fulgenci capulet organiz fiest asist graci mediacion amig mercucci rome montesc capulet pretend jov hij juliet compromet arrog dav paris hij gobern rome juliet mir surg prim moment chisp amor adapt modern clasic shakespear	Drama
jess bhamr jov orig hindu viv famili inglaterr padr des verl termin estudi cas deb respet tradicion pais orig chic sol sueñ balon igual idol campeon dav beckham jess pas mayor part tiemp jug futbol jov ingles jul invit entrar equip femenin inici bell amist gran aventur	Comedia
traidicional socied nipon ofrec gran pelicul experimental toshi matsumot centr vid transexual toki años 60	Drama
francisc jos deb cas aunqu madr pens helen jov princes bav emper enamor perdid elizabeth sissi jov espontane convencional detest protocol cort pes decision cont aprob madr jov enamor har esplend bod sissi primer victori frent famili	Comedia
tras bod vien sissi empiez nuev vid emperatriz austri pront rigidez protocol conviert verdader problem sofi suegr nac profund resent estall cumpleañ hij sissi sofi apel antigu tradicion cort opon niñ cri madr final lleg acuerd sissi podr educ hij si compromet cumpl oblig cortesan	Drama
sissi muestr habil sol asunt sin sof conflict suegr aprovech cualqui ocasion invent fals romanc sissi cond andrassy objet romp matrimoni emperatriz hij amenaz sof añad grav enfermed pulmon sissi contra hungr llev greci tras tiemp jov mejor feliz enfermed	Romance
zuck period limit ley vid punt fracas herenci parec ser salvacion problem clausul convert pesadill	Comedia
retrat trist existent chic maltrat padr humill gent puebl	Drama
erin brockovich madr solter consig puest trabaj pequeñ despach abog personal convencional har comienz demasi alent cambi dec investig extrañ cas client padec sospech enfermed	Drama
tres niñ carreter islandi tripul somnolient bord ferry emu île franc bell rostr islas bijag cementeri gat afuer toki vagabund namidabashi habit isla fog cab verd carnaval bissau asi inici relat muj desconoc lee cart remit oper cam sandor krasn traves registr imagen viaj interrog memori funcion recuerd contrari olvid sin opuest conform sei shônagon particul list cos hac lat corazon	Documental
daniel dareus director orquest fam mundial lleg alto sol miser cans servidumbr fam trabaj tras sufr infart daniel decid pon fin carrer musical regres pequeñ puebl pas infanci situ remot zon nort sueci lleg supon pequeñ revolu pues popular convert objet inmediat curi fascin habit puebl ped consej profesional pequeñ cor iglesi ensay cad juev vestibul parroqui	Romance
lili jovencit 14 años voluptu caravan acamp famili biarritz conscient mism mantien convers caf pianist conciert conoc rach salvaj prob pod hombr descubr siempr control anim accion impacient ser virg march herman discotec aferr viej playboy mism calor fri ambivalent acerc perd virgin noch dispuest siguient determin tercer mezcl depresion misogini playboy termin aventur consum lili caz lug	Drama
nuev york hombr desaparec dej rastr klut donald sutherland polic intim amig encuentr pist cart aquel escrib prostitut llam bre jan fond va verl interrog surg apasion relacion amor mientr klut prosig investig baj fond empiez aparec prostitut asesin entonc asalt sospech bre pued ser proxim victim	Misterio
cuatr joven estudi dos chic dos chic desaparec exclus intern britan dos seman tard aparec chic liz tan traumatiz logr distingu real imaginari unic recuerd libr excursion encerr compañer bunk subterrane junt doctor horwood psicolog polic intent descubr pas bunk sid amig	Crimen
mik waters riv phoenix scott favor keanu reev dos joven chaper gan vid prostituyendos call portland mik extrañ enfermed llam narcolepsi provoc sueñ repentin profund cualqui part	Drama
dos amig prim acab lleg unid budapest viv flor divers aventur popul pelicul cin independient años ochent rod apen 18 dias equip sol once person tres actor ocho tecnic filmaffinity	Comedia
paul rivers brillant profesor universitari cas mary relacion demasi buen paul diagnostic enfermed mortal si recib pront transplant corazon mor irremedi part christin peck encontr tranquil despues pas autent turbulent marc drog alcohol	Drama
unid infraestructur orden control tip comun transport energ sufr devast paron part grup terror cerebr escond tras tram cuent minim detall devast plan cont john mcclan bruc willis polic viej escuel conoc dos cos acerc com frustr amenaz terror hombr adecu tip trabaj	Acción
hombr llam mism inici ole terror call nuev york har deton seri bomb ciud men agent john mcclan acced jug jueg llam dic ayud zeus electric harlem comienz trepid carrer averigu adivin intencion terror	Acción
max brillant matemat punt dar descubr import vid decodif sistem numer rig aparent caos merc bursatil primer encontr valor numer pi mientr acerc verd afect period unas brutal jaquec max acos agres firm wall street sect jud pretend descifr secret ocult tras text sagr ansi apropi inminent hallazg max	Misterio
nuev zeland medi sigl xx amist dos compañer colegi adolescent tan intens estrech despiert recel padr chic cre mund imaginari llen fantas refugi viv espald rest mund bas hech real	Drama
dec 1930 plen gran depresion estadounidens bonni park clyde burrows jov parej band recorr unid desafi autor atrac banc histori andanz dos famos atrac banc unid años 30 bonni clyde dos personaj peligr tremend aficion apret gatill respons numer muert agent ley embarg pelicul da vision amabl	Crimen
portland oregon 1971 bob hugh carismat lid peculi cuartet form espos diann parej rick nadin rob sum habil farmaci hospital objet apacigu insaci neces drog diversion suert dur siempr	Drama
virus mortal sid liber poblacion raccoon city alic mill jovovich supervivient desastr bioquim encuentr corazon devast ciud somet experiment alter genet ahor pose fuerz destrez sobrehuman habil deb utiliz quier sobreviv nuev aventur junt supervivient deb escap cad vez peligr raccoon city alcanz met necesit luch fuerz umbrell corporation violent criatur bioingeni cre laboratori zombi plag ciud final enfrent colosal mortal creacion nemesis	Terror
jak mott jov boxeador entren dur ayud herman joey convert numer pes medi pront consig ver hech realid tan ansi sueñ triunf exit conviert vid pesadill lad matrimoni cad vez march peor deb sal nocturn mujer mafi presion amañ combat tiemp gast capital dispon volv nuev pas tip penuri	Drama
jov walt wad mat estudi negr john shaft detien viol libert condicional acus abandon pais embarg despues esper dos años shaft acab echand guant anonim regres unid millonari padr walt pag fianz nuev walt qued libr dese ver shaft muert unic mism destin quier dos corrupt coleg jack roselli jimmy grovitch asi trafic drog dominican peopl hernandez esper veng shaft hab humill barri control	Acción
prepar eleg bod nuev delhi dur cuatr dias reflej conflict gener partidari segu tradicion defensor modern lalit verm muj pimmi bod concert hij llev casi bord ataqu nervi quiebr histori paralel desarroll med van lleg ciud parient procedent mund novi lleg houston tex trabaj ingenier conoc novi novi part acept compromis regañadient pues enamor present television prepar bod exig contrat organiz profesional eleg p.k dubey inteligent jov clas medi	Comedia
tan adolescent problemat reclu reformatori recib permis especial 48 hor asist bod herman mejor amig richi disfrut hor firm proposit hac prohib centr emborrach drog rob vuelv sent libr med pas hor tan asist desmoron punt referent barri famili amist amor cambi	Drama
detectiv priv john shaft recib visit polic pid inform mafios harlem llam bumpy despues mafios solicit ayud detectiv rescat hij sid secuestr band rival shaft viej amig decid investig asunt infiltr mund hamp encontr chic shaft acab averigu gangst utiliz	Acción
permis carcelari sailor va ver novi lul ambos decid huir californi madr chic opon relacion pon contact mafios elimin sailor realid quier deshac jov presenc com amant asesin mar huid sailor lul va acompañ turbi acontec sord recuerd	Crimen
dewey finn guitarr deliri grandez expuls band desesper encontr trabaj falt diner suplant ident profesor sustitut dar clas escuel priv pequeñ alumn pre-adolescent 5o grad intentará enseñ rock amp roll alto voltaj además alumn está yuki guitarr prodigi 9 años pued ayud dewey gan competición band músic pas solucion problem económ	Comedia
vigili navid bedford falls ny georg bailey plan suicid angel envi deten intent enseñ georg cos maravill juventud com salv vid herman graci hab conoc georg felic asi amig descubr ¡la vid realment tesor maravill deb disfrut	Drama
thrill bas novel steph king depp escritor atravies mal moment sequ creativ une proces separ espos tal circunst aparec vid extrañ personaj acus hab plagi relat	Misterio
gilbert chic pequeñ puebl endor atrap alli oblig familiar tras suicidi padr deb hac carg herman menor deficient dos herman madr obes pes 200 kil aburr vid transcurr colm trabaj famili relacion mantien muj cas lleg puebl jov optim llam becky cambi rutin	Romance
primer guerr mundial capitan barc tendenci beb estir misioner huy trop aleman ruinos embarc ven oblig remont peligr rio primer vist dos ser antagon incompat convivent penal afront junt sobreviv haran cambi radical relacion	Aventura
will jov rebeld inteligent asombr especial matemat descubr talent part academ oblig eleg segu vid siempr trabaj facil buen amig much cervez algun aprovech grand cualidad intelectual algun univers sol consej solitari bohemi profesor ayud decid	Drama
sueci medi sigl xiv pest negr asol europ tras diez años inutil combat cruz caballer suec antonius blovk leal escuder regres tierr sant blovk hombr atorment llen dud camin encuentr muert reclam entonc propon jug part ajedrez esper obten respuest grand cuestion vid muert existent dios	Fantasía
regin cinc años empiez nuev vid junt padr destartal granj keni lleg huyend nazism aleman niñ pront adapt nuev condicion vid padr cuest	Drama
vid craig schwartz lleg final cicl craig marionet callejer gran talent impresion vid carec nuev york cambi gent prest much atencion llev diez años cas lott trabaj tiend animal obsesion trabaj consig encontr trabaj plant 7 5 edifici mertin-flemm manhatt encuentr pequeñ puert permit acces pasill secret aspir permit acced cerebr john malkovich	Comedia
john shaft vuelt polic detectiv negr amad dam busqued asesin client	Acción
detectiv john shaft viaj incognit etiop lueg franci destru red trafic person	Aventura
dos perspect diferent unid veteran vietnam jov sold her guerr 18 años obsesion proteg tierr libert atent 11 septiembr 2001 remuev fantasm pas hombr amig vincul familiar part lan jov ideal viv afric europ ultim diez años	Drama
sach baron coh peculi protagon ali g anda suelt interpret borat reporter kazajistan orden gobiern period va unid rod documental pedagog deb recog mejor enseñ usa pais aprovech trabaj tan facil parec	Comedia
sur unid plen depresion paul edgecomb vigil penitenciari carg mill verd pasill sep celd reclus conden sill electr esper ejecu john coffey gigantesc negr acus asesin brutal dos herman nuev años tras personal ingenu coffey escond don sobrenatural prodigi med transcurr histori paul edgecomb aprend milagr ocurr inclus lugar insospech	Fantasía
bowd parej feliz sam abog exit leig diseñ grafic hij 15 años daniell acab traslad precios cas tranquil ciud max cady acab sal carcel tras pas 14 años acus viol apal adolescent prision estudi ley lleg conclusion respons direct conden abog sam bowd ahor va dedic cad minut existent hac pag error candy ejecut terribl venganz aterroriz famili bowd convirt vid pesadill	Crimen
cle jov cantant esper impacient result exam medic adivin lee cart revel canc pued mor inquietud aument trat ocup tiemp esper result cle conoc jov sold punt part hac servici milit argeli conf temor muert	Drama
band organiz form seis individu contrat dar golp anterior vari miembr conoc usan nombr clav objet atrac empres llev diamant suen alarm polic alli muer atrac rest reun lug conven	Crimen
1990 2003 timothy treadwell camarer actor ocasional ex-alcohol pas catorc veran conviv osos grizzly mism grab cam vide estanci alask obses relacion plantigr unas cien hor wern herzog uso part material ultim veran osos atac timothy novi anni	Documental
guerr fri error informat escuadron bombarder sac envi destru moscu president unid henry fond trat hac volv sofistic sistem segur impid abort ataqu asi deb convenc union soviet contraataqu	Drama
atlant nort bord lujos trasatlant poseidon veint pis trec cubiert comienz fiest nocheviej mientr gigantesc ola treint metr altur dirig haci nav gran veloc intent desvi barc evit choqu inutil ola golpe fuerz colosal vuelc pasajer miembr tripul caen gran altur van par rest naufragi sumerg mar tras espectacul dramat vuelc tub gas qued rot escup fueg electr fall dej grand seccion buqu sumerg oscur caos	Aventura
bas hech real ail wuorn prostitut ejecut 2002 flor tras confes autor seis asesinat inclu polic ail declar mat defens propi reaccion violent ataqu sufri mientr ejerc ofici bord desesper suicidi conoc dia bar selby wall jov lesbian sid envi padr viv tia cur homosexual wuorn victim tragic infanci llen abus rapid enamor selby encontr razon viv incapaz encontr trabaj dign wuorn sig ejerc prostitu client maltrat mat defens propi comenz asi tragic caden asesinat histori asesin histori amor dos inadapt	Crimen
johnny guap mickey rourk conoc nombr deb terribl deform car prision pag rob complic dej tir asesin ademas mejor amig polic propon sal cambi nombr criminal johnny res propi codig moral ademas blanc inconfund aspect cirujan plastic ofrec posibil cambi rostr form baj ident comienc nuev johnny acept aunqu parec hab sal bien cirug logr borr recuerd pas	Crimen
marni embuster ladron compuls sirv trabaj secretari rob mark rutland contrat sol abandon delict habit sin ademas comport maner absolut desquici pes mark ced impuls inexplic decid cas averigu razon obses comport terribl accident llev marni situacion limit mark oblig enfrent terror cuy raic hund pas	Crimen
zed eric stoltz ladron caj fuert american lleg par ayud eric jean-hugh anglad amig infanci atrac banc lleg capital frances taxist ofrec zed espos noch abrir puert habit hotel zed encuentr ador parisin llam zoe juli delpy pasion ambos interrump brusc eric irrump habit echa zoe aun desnud arrastr zed conozc miembr band dia siguient irrump banc tom rehen inclu zoe dia trabaj secretari banc vez dentr tension va aument atrac pierd control situacion rehen cadaver van aument polic rode edifici	Acción
londr navidad entrelaz seri histori divert conmovedor actually maner abrevi dec actually is all around este precis argument pelicul mir mir encontr amor tod part personaj cad maner prim ministr viej estrell rock asistent portugues sol habl idiom relacion aspect divert trist ingenu estup amor	Comedia
histori centr william propietari tiend libr popul barri londinens notting hill anna scott estrell rutil firmament cinematograf moment actriz entra tiend william embarc cortej complic cuent inestim ayud insepar amig destac compañer pis singul spik observ asombr incredul com buen william romanc muj inalcanz cualqui ser human	Romance
randl mcmurphy jack nicholson violador espiritu libr viv contracorrient reclu hospital psiquiatr inflex disciplin centr acentu contagi tendenci desord acab desencaden guerr pacient personal clinic fri sever enfermer ratch louis fletch cabez suert cad pacient pabellon jueg	Drama
final sigl xix ciud lodz convert epicentr industri textil consiguient neces man obra inmigr tres joven estudi rig polac catol hij nobl terratenient ambici judi aleman luteran decid abrir fabric ciud hac fortun escrupul prejuici lanz acumul diner pod filmaffinity	Drama
sondr pransky scarlett johansson estudi american period encuentr gran bretañ visit amig estanci londr acud espectacul magi ilusion woody allen invit sub escenari hac desaparec mientr esper mag pong practic truc recib visit fantasm prestigi period muert ian mcshan ven alla serv bandej exclus año espiritu afirm pet lyman hugh jackm ric atract hij conoc aristocrat britan realid famos asesin seri conoc asesin tarot	Comedia
ashok llev cas 15 años rahd llev pes negoci famili convert alma cas viv madr herman mar aparent armon entrad clan sit jov espos cuñ revolucion entorn rahd primer obra conoc trilog meht sigu tierr 1998 agu 2005 filmaffinity	Drama
coronel cientif mov distint interes investig misteri hallazg unas excav extrañ artefact llam puert estrell acompañ equip reconoc atravies puert transport lejan planet	Acción
muj fabric armas secuestr hombr busc venganz muert hij tirote escuel empiez joe wesley snip padr desesper tras asesinat hij arma larg alcanz busc venganz rifl mism condicion secuestr liberty wallac lind fiorentin muj fabric arma homic victor wallac oliv platt muj atad tramp explos francotir azote telefon contact unas norm segu desenlac imprevis situacion extrem	Suspense
aristocrat sid abandon amant ejecut acab ser desped tras ser sustitu rival decid suicid arroj rio tamesis parej encontr plan mejor intercambi respect venganz	Comedia
histori conflict jueg pod secret famili ric mississippi	Película de TV
segun revist rolling ston magnif piez entreten captur vital locur rock años sesent	Comedia
tras secuestr madr alquil dos fri profesional crim ven envuelt espiral crecient confusion violenci	Acción
bas famos videojueg mism nombr agent 47 olyphant contrat misteri organización conoc agenci mat diner cazador convertirá pres tras cambi régim polít interpol ejércit rus perseguirá asesin tod europ mientr él intent averigu quién tendió tramp qué	Acción
tony wendic maquin plan deshac margot espos infiel casual har final acus asesinat inestim ayud inspector polic ayud resolv misteri crim	Crimen
ed wood jov director cin visionari ningun formacion academ aficion vest muj poc oportun hac pelicul gran estudi embarg cej empeñ convert director famos tras reun curios grup personaj realiz pelicul baj presupuest excentr cuid tecnic	Comedia
años 70 ciud sur alemani viv micael muchach cri famili profund religi padr cariñ debil madr fri distant pes llev años libr dur batall epilepsi micael dese fervient sal cas ir univers vez alli sabore libert primer vez incipient amor stef amist hann hac romp escud fe famili baj siempr segur proteg bas mism personaj inspir histori exorc emily ros filmaffinity	Drama
veg 1973 sam ace rothstein profesional apuest eficaz director import casin pertenec grup mafios mision control funcion negoci garantiz corrient diner va par man jef sig flu veg lug ideal millonari polit lug pas tahur prestam trafic drog maton dia violent nicky santor jef encarg cuid sam lleg veg intencion qued	Crimen
tras pas años carcel rob man armad jak blu puest libert buen comport sal prision vest mism form entro traj sombrer negr gaf oscur puert esper herman elwood vest ident maner ahor unic hog conoc peligr orfelinat sant elen necesit gran cantid diner herman pon man obra	Música
epoc magi aventur leyend heroic sobrenatural relat diabol venganz obisp aquil consecuent traicion jur imped amor navarr isabel apoder fuerz mal lanz parej terribl hechiz convert halcon dia acech lob gris noch etern unid separ encontr ali person philipp ayud conjur maldicion obisp	Aventura
nuev zeland famili descendient guerrer mahor viv igual suburbi gran ciud situacion marginal respect person raz blanc vid famili clan presid problem alcohol delincuent escas medi econom	Drama
conoc 1912 jul oskar wern jim henri serr convirt dos insepar amig dia enamor mism muj catherin jeann moreau final cas obra capital cin frances sesent hermos cant amor pasion	Drama
godard maoism estren año may 68 chinois relat inquietud cambi mund grup estudi frances empap pensamient mao tse tung par veran 1967 poc intent aplic principi romp burgues urss part comun occidental nombr mao tse tung empap pensamient mao literatur comun grup estudi frances empiez pregunt posicion mund posibil cambi aunqu signifiqu consider terror posibl via	Comedia
wallac insepar perr gromit disfrut dia picnic sobrepon imprevist contratiemp	Animación
nuev aventur wallac regal mod pantalon gromit acab sal car esper despues conoc huesp hosped cas aparent inocent pingüin	Animación
famili martin siempr pasion motor corr ven mari cabez famili ve forz despej camin jov talent giuli hij unir herman mayor loris ex-pilot fiabl ahor conserv agudisim trayectori motor junt deb regres carrer mientr intent escap propi demoni aprend signif dur pued lleg ser ser famili	Familia
acerc concurs anual verdur gigant desat vegetalman puebl wallac gromit dos amig hac oro invent sistem anti-pest form humanitari control conej intent invad preci huert pront vien abaj enorm misteri voraz besti empiez aterroriz vecindari atac huert noch organiz concurs lady tottington absolut desesper encarg anti-pest captur terribl criatur salv concurs victor quartermain engreid pretendient lady tottington acech decid mat besti tir convert hero local consegu cas ric hereder concurs jueg lady tottington remedi dej victor vay detras voraz criatur verdader intencion cazador pued ten grav consecuent	Aventura
nuev entreg sag terminator transcurr post-apocalipt 2018 tras dia juici final john connor hombr destin lider resistent human skynet ejercit terminators futur connor enseñ cre ve alter part aparicion marcus wright extrañ cuy ultim recuerd hab corredor muert afirm hab kyle rees padr john connor deb decid si marcus sid envi futur rescat pas carrer contrareloj mientr resistent prep ataqu final corazon centr oper skynet	Acción
alex owens jov huerfan sueñ lleg ser bailarin pod viv ademas pag clas bail dia trabaj soldador noch bail club nocturn	Drama
elliot asesor informat llen buen intencion autent desastr hor hac amig cae perdid enamor alison compañer trabaj siqu sab exist desesper conquist vend alma diabl cambi siet dese	Fantasía
jean-claud delsart agent judicial 50 años resign hac tiemp vid alicient dia decid aprend bail tang academi situ frent despach	Romance
pequeñ pobl cost nuev zeland aborigen tribu whang cre proced unic ancestr cuy existent remont mil años atras nombr paike escap muert tras volc cano mont lom ballen segun tradicion jef whang whal rid paike ser primogenit varon pai niñ once años cre destin ser maxim autor tribu ello aunqu ador abuel kor enfrent mil años tradicion	Drama
jov secretari tras comet rob march ciud conduc hor par descans pequeñ motel carreter regent jov llam norm parec normal tranquil apart motel cas lad viv norm madr mientr duch jov asesin salvaj cuchill	Terror
histori grup sexys colegial agent secret lucy diamond jordan brewst atract jef grup criminal vuelt unid grup espi form chic institut sig pist agent import bell amy bradshaw sar fost desaparec misteri tras enfrent car car delincuent d.e.b.s comienz busc escondit lucy sospech quiz amy quier ser rescat	Acción
franki machin malhechor adict jueg heroin interpret soberbi frank sinatr tras pas buen tempor carcel regres cas chicag junt muj eleanor park firm proposit dej atras pas criminal rehabilit adiccion result facil esper viej indes amistad trat medi regres antigu habit	Drama
amar vier jov sacerdot recien sal seminari conviert asistent padr benit parroc pequeñ puebl eclesiast precis model segu puest mantien relacion muj dud hac trat narcotraf consegu diner iglesi padr amar intent huir comport superior pon prueb carrer sacerdot tras conoc ameli muchach hermos ciud	Drama
londr 1929 frank webb detectiv scotland yard ocup parec interes trabaj alic whit novi sint ignor alic acept sal eleg artist educ maner invit visit lujos apartament	Drama
ted strohehmann viv angusti 14 años vid razon desgraci famos mary jens chic des fin consig ten cit fiest graduacion desgraci accident cremaller pantalon arruin plan ahor parec oportun	Romance
tranquil local sureñ mississippi dos joven borrach viol salvaj niñ negr diez años mayor blanc ciud muestr horroriz tan atroz crim carl lee padr niñ armad rifl asalt decid tom justici man mat violador hij mientr tension va crec reaparec call cruc ardiend ku klux klan jak briganc jov abog blanc har posibl salv vid carl lee proteg	Crimen
vid transexual oper felicity huffm experiment gir insolit averigu hombr hij adolescent dedic vag call nuev york	Drama
grac amig judith sal dar pase caball sufr terribl accident ser atropell trail judith caball muer mientr grac pilgrim result gravement her intent desesper recuper pilgrim accident convert caball salvaj ani madr grac decid ir montan ver tom book vaquer pose facult especial habl cur caball	Aventura
japon sigl xii kiot baj puert derru templ rashomon guarec torrencial lluvi leñador sacerdot budist peregrin tres discut juici band acus hab dad muert señor feudal viol espos detall crim narr punt vist band muj señor feudal ayud leñador unic testig hech	Crimen
biograf jean-michel basquiat pintor vanguard pas ser jov desconoc pint graffitis brooklyn convert controvert famos pintur contemporane mundial comienz años ochent descubiert andy warhol exposicion convirtireron acontec escen artist neoyorquin epoc cuadr adquir import muse coleccion priv mientr enfrent espectacul fulgur fam sumerg mund drog heroin artist mur sobredosis 27 años	Drama
